Orthogroup	Ceratina_australensis-longest-isoforms	Ceratina_calcarata-longest-isoforms	Liostenogaster_flavolineata-longest-isoforms	Megalopta_genalis-longest-isoforms	Polistes_canadensis-longest-isoforms	Polistes_dominula-longest-isoforms	Total
OG0000000	8	18	5	16	22	27	96
OG0000001	8	7	29	0	16	16	76
OG0000002	1	5	1	34	4	27	72
OG0000003	15	9	11	9	10	9	63
OG0000004	7	5	12	12	9	9	54
OG0000005	2	0	42	1	0	1	46
OG0000006	2	0	44	0	0	0	46
OG0000007	0	7	3	1	13	21	45
OG0000008	1	11	1	5	16	2	36
OG0000009	3	21	1	2	2	6	35
OG0000010	1	24	2	0	4	4	35
OG0000011	4	9	6	2	5	8	34
OG0000012	7	4	7	7	4	4	33
OG0000013	1	13	1	1	14	3	33
OG0000014	2	16	3	3	3	5	32
OG0000015	1	0	23	1	2	4	31
OG0000016	1	10	1	3	14	2	31
OG0000017	4	1	5	15	1	4	30
OG0000018	4	3	12	5	2	4	30
OG0000019	2	5	5	9	4	5	30
OG0000020	1	8	6	4	6	5	30
OG0000021	5	4	1	9	2	8	29
OG0000022	5	6	2	11	1	4	29
OG0000023	2	2	1	10	4	10	29
OG0000024	1	11	0	9	2	6	29
OG0000025	2	8	4	7	4	3	28
OG0000026	1	16	1	2	2	6	28
OG0000027	0	0	0	0	3	25	28
OG0000028	12	3	1	0	6	5	27
OG0000029	2	6	2	0	3	14	27
OG0000030	1	1	18	4	0	3	27
OG0000031	2	15	2	3	3	1	26
OG0000032	1	0	16	0	5	4	26
OG0000033	2	2	3	5	5	9	26
OG0000034	4	8	2	3	7	2	26
OG0000035	2	11	2	7	2	2	26
OG0000036	1	7	1	10	4	2	25
OG0000037	5	2	4	3	4	6	24
OG0000038	4	8	1	5	3	3	24
OG0000039	4	3	5	6	5	1	24
OG0000040	1	6	1	11	3	2	24
OG0000041	3	4	6	2	5	4	24
OG0000042	3	4	2	3	11	1	24
OG0000043	1	10	1	7	1	4	24
OG0000044	1	10	1	10	1	1	24
OG0000045	2	5	2	2	3	10	24
OG0000046	1	11	1	9	1	1	24
OG0000047	1	13	1	4	3	2	24
OG0000048	2	4	2	2	9	4	23
OG0000049	1	16	1	0	2	3	23
OG0000050	7	1	9	3	2	1	23
OG0000051	2	14	1	0	4	2	23
OG0000052	1	10	1	1	8	2	23
OG0000053	1	5	1	9	1	6	23
OG0000054	5	6	0	6	2	4	23
OG0000055	8	2	3	2	2	6	23
OG0000056	3	8	1	3	5	3	23
OG0000057	5	5	4	2	2	5	23
OG0000058	1	8	5	4	2	3	23
OG0000059	2	12	1	2	3	3	23
OG0000060	1	8	1	1	8	4	23
OG0000061	0	5	1	2	6	9	23
OG0000062	5	3	4	5	4	1	22
OG0000063	1	6	1	5	7	2	22
OG0000064	1	7	1	6	1	6	22
OG0000065	2	14	2	0	2	2	22
OG0000066	0	12	1	2	2	5	22
OG0000067	1	3	1	3	1	12	21
OG0000068	1	11	1	3	2	3	21
OG0000069	2	3	5	1	4	6	21
OG0000070	4	7	1	3	3	3	21
OG0000071	7	2	0	5	3	4	21
OG0000072	1	6	1	2	1	10	21
OG0000073	0	15	1	1	1	3	21
OG0000074	7	13	0	0	0	0	20
OG0000075	1	4	1	2	9	3	20
OG0000076	2	3	0	2	0	13	20
OG0000077	3	3	1	3	4	6	20
OG0000078	6	7	0	3	2	2	20
OG0000079	3	3	4	2	4	4	20
OG0000080	2	1	1	2	4	10	20
OG0000081	1	5	1	0	4	9	20
OG0000082	1	3	1	9	1	5	20
OG0000083	3	1	7	3	3	3	20
OG0000084	6	2	4	4	2	2	20
OG0000085	1	8	1	5	2	3	20
OG0000086	1	8	4	4	1	2	20
OG0000087	1	7	1	5	2	4	20
OG0000088	0	10	1	3	4	2	20
OG0000089	3	3	2	4	2	5	19
OG0000090	18	0	1	0	0	0	19
OG0000091	1	5	1	1	1	10	19
OG0000092	4	2	4	4	2	3	19
OG0000093	2	13	0	1	1	2	19
OG0000094	6	2	6	3	1	1	19
OG0000095	1	4	0	3	4	7	19
OG0000096	1	2	1	11	2	2	19
OG0000097	1	6	1	7	2	2	19
OG0000098	4	2	4	3	4	2	19
OG0000099	2	5	1	2	2	7	19
OG0000100	2	10	1	1	3	2	19
OG0000101	2	8	1	2	1	5	19
OG0000102	2	7	1	7	1	1	19
OG0000103	2	6	1	1	2	7	19
OG0000104	2	1	0	15	0	1	19
OG0000105	1	6	1	8	1	2	19
OG0000106	2	6	2	1	3	5	19
OG0000107	1	9	1	3	2	3	19
OG0000108	1	12	1	3	1	1	19
OG0000109	1	1	1	1	2	13	19
OG0000110	1	10	0	6	1	1	19
OG0000111	0	0	19	0	0	0	19
OG0000112	3	4	3	3	2	3	18
OG0000113	1	8	1	2	5	1	18
OG0000114	3	1	5	1	2	6	18
OG0000115	1	4	1	3	1	8	18
OG0000116	1	0	15	2	0	0	18
OG0000117	3	3	4	1	4	3	18
OG0000118	1	6	1	4	5	1	18
OG0000119	1	8	1	2	2	4	18
OG0000120	1	1	5	4	3	4	18
OG0000121	1	6	2	4	3	2	18
OG0000122	4	5	1	4	3	1	18
OG0000123	1	1	2	4	5	5	18
OG0000124	1	7	1	1	1	7	18
OG0000125	2	6	1	2	2	5	18
OG0000126	1	2	1	1	4	9	18
OG0000127	1	10	1	2	2	2	18
OG0000128	3	5	4	1	3	2	18
OG0000129	5	1	3	2	4	3	18
OG0000130	1	12	1	2	1	1	18
OG0000131	1	7	1	4	3	2	18
OG0000132	1	4	2	5	1	5	18
OG0000133	1	8	1	2	4	2	18
OG0000134	0	0	1	0	2	15	18
OG0000135	1	5	1	1	1	8	17
OG0000136	1	5	2	2	5	2	17
OG0000137	3	2	1	2	4	5	17
OG0000138	2	4	1	2	2	6	17
OG0000139	1	4	1	7	3	1	17
OG0000140	6	1	6	1	0	3	17
OG0000141	7	10	0	0	0	0	17
OG0000142	1	7	1	3	2	3	17
OG0000143	4	1	2	2	5	3	17
OG0000144	2	2	1	2	3	7	17
OG0000145	1	6	2	2	2	4	17
OG0000146	2	5	2	3	3	2	17
OG0000147	2	5	1	1	2	6	17
OG0000148	1	7	1	3	4	1	17
OG0000149	3	3	1	4	2	4	17
OG0000150	1	5	1	1	2	7	17
OG0000151	1	5	1	2	5	3	17
OG0000152	1	3	1	3	2	7	17
OG0000153	3	6	0	8	0	0	17
OG0000154	1	4	1	2	6	3	17
OG0000155	1	6	1	3	4	2	17
OG0000156	2	4	1	2	6	2	17
OG0000157	1	4	2	3	3	4	17
OG0000158	2	4	2	6	2	1	17
OG0000159	1	9	1	2	2	2	17
OG0000160	1	10	1	2	2	1	17
OG0000161	1	5	2	3	2	4	17
OG0000162	2	6	1	4	3	1	17
OG0000163	2	2	6	4	2	1	17
OG0000164	2	5	1	5	2	2	17
OG0000165	1	1	1	2	9	3	17
OG0000166	1	2	1	4	3	6	17
OG0000167	1	4	1	3	5	3	17
OG0000168	1	5	1	4	4	2	17
OG0000169	1	16	0	0	0	0	17
OG0000170	1	6	1	3	5	1	17
OG0000171	0	15	1	0	1	0	17
OG0000172	0	17	0	0	0	0	17
OG0000173	0	1	1	8	3	4	17
OG0000174	0	9	1	2	3	2	17
OG0000175	0	0	1	1	3	12	17
OG0000176	3	3	4	1	1	4	16
OG0000177	2	3	1	5	2	3	16
OG0000178	5	3	4	2	1	1	16
OG0000179	1	2	1	3	2	7	16
OG0000180	9	3	1	1	0	2	16
OG0000181	1	3	2	3	4	3	16
OG0000182	2	4	1	3	3	3	16
OG0000183	4	0	1	1	8	2	16
OG0000184	2	5	1	2	3	3	16
OG0000185	1	4	2	2	4	3	16
OG0000186	1	7	2	5	1	0	16
OG0000187	1	8	0	2	3	2	16
OG0000188	2	3	1	6	3	1	16
OG0000189	1	4	1	7	1	2	16
OG0000190	6	2	2	4	1	1	16
OG0000191	2	6	1	4	2	1	16
OG0000192	1	5	1	2	2	5	16
OG0000193	2	9	0	4	0	1	16
OG0000194	1	6	1	3	3	2	16
OG0000195	1	0	3	1	6	5	16
OG0000196	3	4	2	2	1	4	16
OG0000197	1	5	2	2	2	4	16
OG0000198	3	2	3	2	3	3	16
OG0000199	2	1	4	5	2	2	16
OG0000200	2	6	1	5	1	1	16
OG0000201	2	9	1	1	1	2	16
OG0000202	2	6	1	6	1	0	16
OG0000203	2	4	1	2	2	5	16
OG0000204	1	2	3	3	4	3	16
OG0000205	1	5	1	2	2	5	16
OG0000206	3	1	4	2	3	3	16
OG0000207	1	5	1	3	2	4	16
OG0000208	1	5	1	3	4	2	16
OG0000209	1	5	1	2	5	2	16
OG0000210	2	6	1	2	3	2	16
OG0000211	1	10	0	3	1	1	16
OG0000212	2	4	1	2	4	3	16
OG0000213	3	4	2	1	4	2	16
OG0000214	1	8	1	2	1	3	16
OG0000215	1	7	1	5	1	1	16
OG0000216	1	10	1	2	1	1	16
OG0000217	1	12	1	1	1	0	16
OG0000218	1	8	1	1	3	2	16
OG0000219	3	6	1	2	2	2	16
OG0000220	1	2	2	3	5	3	16
OG0000221	1	4	1	2	1	7	16
OG0000222	1	7	1	1	1	5	16
OG0000223	1	4	2	2	5	2	16
OG0000224	3	5	1	2	3	2	16
OG0000225	0	5	2	4	2	3	16
OG0000226	0	1	1	7	4	3	16
OG0000227	0	7	1	3	2	3	16
OG0000228	0	0	1	1	12	2	16
OG0000229	0	0	0	1	15	0	16
OG0000230	6	0	2	1	1	5	15
OG0000231	3	1	4	3	1	3	15
OG0000232	8	6	1	0	0	0	15
OG0000233	4	2	2	2	2	3	15
OG0000234	1	7	1	2	2	2	15
OG0000235	1	11	0	1	1	1	15
OG0000236	4	1	2	4	1	3	15
OG0000237	5	3	1	1	1	4	15
OG0000238	2	6	1	2	1	3	15
OG0000239	1	3	1	2	6	2	15
OG0000240	1	3	6	2	2	1	15
OG0000241	2	4	1	2	4	2	15
OG0000242	3	2	2	2	4	2	15
OG0000243	12	1	0	1	0	1	15
OG0000244	13	1	0	0	0	1	15
OG0000245	2	4	4	2	0	3	15
OG0000246	1	3	1	4	4	2	15
OG0000247	2	7	1	2	1	2	15
OG0000248	4	3	1	2	3	2	15
OG0000249	3	4	1	2	3	2	15
OG0000250	5	1	5	3	0	1	15
OG0000251	1	4	1	6	1	2	15
OG0000252	1	3	1	3	5	2	15
OG0000253	2	4	2	3	2	2	15
OG0000254	2	3	3	2	4	1	15
OG0000255	1	3	1	6	1	3	15
OG0000256	1	6	1	1	3	3	15
OG0000257	2	5	1	3	3	1	15
OG0000258	3	1	1	3	2	5	15
OG0000259	2	4	2	2	3	2	15
OG0000260	5	4	1	0	2	3	15
OG0000261	2	8	0	1	2	2	15
OG0000262	4	1	1	2	3	4	15
OG0000263	1	5	1	3	3	2	15
OG0000264	2	3	1	4	1	4	15
OG0000265	2	4	1	4	1	3	15
OG0000266	3	5	1	1	1	4	15
OG0000267	1	4	1	2	4	3	15
OG0000268	2	3	1	3	2	4	15
OG0000269	3	0	3	4	3	2	15
OG0000270	3	5	1	4	1	1	15
OG0000271	1	7	1	1	2	3	15
OG0000272	2	2	1	4	4	2	15
OG0000273	1	5	2	3	1	3	15
OG0000274	1	3	1	2	7	1	15
OG0000275	1	5	1	1	4	3	15
OG0000276	1	7	1	1	2	3	15
OG0000277	1	3	1	3	3	4	15
OG0000278	1	9	1	1	2	1	15
OG0000279	1	3	3	4	3	1	15
OG0000280	1	5	1	1	3	4	15
OG0000281	2	5	1	3	1	3	15
OG0000282	1	5	2	1	3	3	15
OG0000283	1	7	1	1	3	2	15
OG0000284	2	1	4	4	2	2	15
OG0000285	1	3	1	2	5	3	15
OG0000286	1	5	1	3	2	3	15
OG0000287	1	1	2	9	1	1	15
OG0000288	1	7	1	2	2	2	15
OG0000289	2	5	2	1	1	4	15
OG0000290	1	3	1	3	4	3	15
OG0000291	1	3	1	3	2	5	15
OG0000292	1	6	1	1	2	4	15
OG0000293	1	8	1	1	2	2	15
OG0000294	2	4	2	2	2	3	15
OG0000295	2	4	3	1	2	3	15
OG0000296	1	2	1	7	2	2	15
OG0000297	1	4	4	2	1	3	15
OG0000298	0	9	1	3	1	1	15
OG0000299	0	9	1	2	1	2	15
OG0000300	0	5	1	4	3	2	15
OG0000301	0	6	1	2	3	3	15
OG0000302	0	3	1	3	6	2	15
OG0000303	0	0	15	0	0	0	15
OG0000304	0	0	14	1	0	0	15
OG0000305	0	0	1	0	3	11	15
OG0000306	2	7	2	1	1	1	14
OG0000307	4	2	2	3	2	1	14
OG0000308	2	3	1	2	3	3	14
OG0000309	1	6	0	1	2	4	14
OG0000310	1	7	1	0	3	2	14
OG0000311	2	8	1	1	1	1	14
OG0000312	2	5	1	2	1	3	14
OG0000313	3	8	1	0	2	0	14
OG0000314	7	6	0	0	0	1	14
OG0000315	2	6	1	2	1	2	14
OG0000316	1	4	1	2	3	3	14
OG0000317	1	4	1	3	3	2	14
OG0000318	1	3	1	2	5	2	14
OG0000319	3	1	1	2	2	5	14
OG0000320	1	2	1	2	7	1	14
OG0000321	5	2	2	4	0	1	14
OG0000322	1	2	0	6	4	1	14
OG0000323	1	6	1	1	3	2	14
OG0000324	4	1	2	3	1	3	14
OG0000325	2	4	2	1	2	3	14
OG0000326	1	1	1	3	6	2	14
OG0000327	3	2	2	2	2	3	14
OG0000328	2	4	1	2	1	4	14
OG0000329	2	4	1	2	1	4	14
OG0000330	2	3	2	4	1	2	14
OG0000331	1	2	2	3	4	2	14
OG0000332	1	4	1	2	2	4	14
OG0000333	4	2	2	1	3	2	14
OG0000334	1	4	1	1	5	2	14
OG0000335	1	4	1	2	3	3	14
OG0000336	2	2	2	3	3	2	14
OG0000337	4	3	1	1	4	1	14
OG0000338	4	5	0	0	2	3	14
OG0000339	1	3	1	6	2	1	14
OG0000340	1	2	1	3	2	5	14
OG0000341	1	6	1	2	1	3	14
OG0000342	4	4	0	4	1	1	14
OG0000343	1	9	1	0	3	0	14
OG0000344	2	3	1	5	2	1	14
OG0000345	1	3	1	0	8	1	14
OG0000346	2	1	1	3	6	1	14
OG0000347	1	0	1	5	3	4	14
OG0000348	3	2	1	3	3	2	14
OG0000349	1	1	11	1	0	0	14
OG0000350	3	4	2	2	3	0	14
OG0000351	1	4	1	2	4	2	14
OG0000352	1	4	1	4	1	3	14
OG0000353	1	4	1	6	1	1	14
OG0000354	2	5	1	2	3	1	14
OG0000355	3	1	2	5	0	3	14
OG0000356	1	6	1	4	1	1	14
OG0000357	2	2	1	2	4	3	14
OG0000358	1	7	1	3	1	1	14
OG0000359	2	2	2	3	3	2	14
OG0000360	3	1	1	3	5	1	14
OG0000361	2	4	1	1	1	5	14
OG0000362	1	3	1	2	2	5	14
OG0000363	1	5	3	3	1	1	14
OG0000364	2	7	1	1	2	1	14
OG0000365	1	1	2	2	6	2	14
OG0000366	1	6	0	2	3	2	14
OG0000367	1	2	4	2	2	3	14
OG0000368	1	0	6	1	2	4	14
OG0000369	1	2	5	1	3	2	14
OG0000370	1	6	1	3	2	1	14
OG0000371	2	0	1	5	3	3	14
OG0000372	1	1	1	1	2	8	14
OG0000373	2	5	1	3	1	2	14
OG0000374	1	5	1	1	3	3	14
OG0000375	1	3	0	8	1	1	14
OG0000376	2	0	8	4	0	0	14
OG0000377	1	7	1	0	1	4	14
OG0000378	1	4	1	6	1	1	14
OG0000379	1	5	1	2	2	3	14
OG0000380	2	0	3	3	2	4	14
OG0000381	1	4	1	0	3	5	14
OG0000382	1	8	1	2	1	1	14
OG0000383	1	2	3	4	3	1	14
OG0000384	0	2	1	5	2	4	14
OG0000385	0	9	2	0	2	1	14
OG0000386	0	5	1	1	2	5	14
OG0000387	0	4	1	1	2	6	14
OG0000388	0	7	1	2	2	2	14
OG0000389	0	8	1	2	1	2	14
OG0000390	0	5	0	2	2	5	14
OG0000391	0	4	1	6	2	1	14
OG0000392	0	3	1	1	8	1	14
OG0000393	0	6	0	2	2	4	14
OG0000394	0	7	1	1	4	1	14
OG0000395	0	1	1	10	1	1	14
OG0000396	2	6	1	2	1	1	13
OG0000397	2	1	1	4	2	3	13
OG0000398	3	2	2	1	3	2	13
OG0000399	2	5	1	3	0	2	13
OG0000400	2	2	2	2	2	3	13
OG0000401	3	5	1	1	1	2	13
OG0000402	3	1	1	1	5	2	13
OG0000403	1	0	1	4	5	2	13
OG0000404	1	1	0	3	7	1	13
OG0000405	3	1	3	3	1	2	13
OG0000406	2	4	1	1	2	3	13
OG0000407	1	2	1	6	3	0	13
OG0000408	3	4	1	2	1	2	13
OG0000409	1	4	1	3	2	2	13
OG0000410	3	3	1	1	3	2	13
OG0000411	1	8	1	2	1	0	13
OG0000412	3	2	2	1	2	3	13
OG0000413	3	2	0	0	2	6	13
OG0000414	2	6	1	1	2	1	13
OG0000415	2	4	1	1	3	2	13
OG0000416	3	2	2	3	1	2	13
OG0000417	1	3	1	2	2	4	13
OG0000418	2	1	4	2	2	2	13
OG0000419	2	3	2	3	2	1	13
OG0000420	3	2	1	3	2	2	13
OG0000421	2	6	1	1	1	2	13
OG0000422	2	0	2	4	4	1	13
OG0000423	4	3	1	2	1	2	13
OG0000424	1	3	1	2	3	3	13
OG0000425	1	6	1	0	3	2	13
OG0000426	1	3	1	1	3	4	13
OG0000427	1	6	1	1	2	2	13
OG0000428	3	4	1	1	2	2	13
OG0000429	3	2	2	2	2	2	13
OG0000430	2	3	2	3	2	1	13
OG0000431	1	6	1	1	1	3	13
OG0000432	2	4	1	3	2	1	13
OG0000433	2	2	1	3	2	3	13
OG0000434	1	6	1	1	1	3	13
OG0000435	2	2	1	4	2	2	13
OG0000436	1	3	2	4	1	2	13
OG0000437	1	1	1	3	4	3	13
OG0000438	1	3	1	1	2	5	13
OG0000439	2	1	1	2	1	6	13
OG0000440	2	4	1	0	4	2	13
OG0000441	2	2	0	0	2	7	13
OG0000442	2	1	1	1	1	7	13
OG0000443	3	3	1	1	1	4	13
OG0000444	2	0	1	3	1	6	13
OG0000445	2	4	1	1	2	3	13
OG0000446	1	3	1	2	4	2	13
OG0000447	1	2	1	1	6	2	13
OG0000448	3	2	3	2	2	1	13
OG0000449	2	3	2	2	2	2	13
OG0000450	4	3	3	1	1	1	13
OG0000451	1	6	1	1	3	1	13
OG0000452	1	3	3	1	3	2	13
OG0000453	1	4	1	2	2	3	13
OG0000454	2	4	2	1	2	2	13
OG0000455	1	3	1	2	2	4	13
OG0000456	1	2	3	1	4	2	13
OG0000457	3	3	2	1	1	3	13
OG0000458	1	4	1	3	1	3	13
OG0000459	1	3	1	1	3	4	13
OG0000460	1	4	1	2	4	1	13
OG0000461	1	7	1	1	1	2	13
OG0000462	1	4	1	2	3	2	13
OG0000463	1	5	1	3	2	1	13
OG0000464	1	3	1	2	4	2	13
OG0000465	1	7	1	1	2	1	13
OG0000466	1	4	2	3	1	2	13
OG0000467	1	2	0	3	3	4	13
OG0000468	2	2	1	3	2	3	13
OG0000469	2	3	2	2	2	2	13
OG0000470	3	3	2	1	2	2	13
OG0000471	1	2	1	4	2	3	13
OG0000472	1	2	2	4	2	2	13
OG0000473	1	4	1	3	2	2	13
OG0000474	1	4	2	2	2	2	13
OG0000475	2	1	4	1	2	3	13
OG0000476	2	4	1	2	2	2	13
OG0000477	1	2	2	1	6	1	13
OG0000478	3	1	4	3	1	1	13
OG0000479	1	5	1	2	2	2	13
OG0000480	2	4	1	2	3	1	13
OG0000481	1	4	1	1	3	3	13
OG0000482	1	3	1	3	1	4	13
OG0000483	1	3	1	3	3	2	13
OG0000484	1	0	1	3	6	2	13
OG0000485	1	10	1	0	1	0	13
OG0000486	0	1	1	0	10	1	13
OG0000487	0	4	1	2	4	2	13
OG0000488	0	5	1	2	1	4	13
OG0000489	0	5	1	2	3	2	13
OG0000490	0	1	1	2	3	6	13
OG0000491	0	6	1	1	2	3	13
OG0000492	0	4	1	1	2	5	13
OG0000493	0	7	1	2	2	1	13
OG0000494	0	6	1	2	2	2	13
OG0000495	0	8	1	2	1	1	13
OG0000496	0	1	1	5	1	5	13
OG0000497	0	4	1	3	3	2	13
OG0000498	0	0	12	0	1	0	13
OG0000499	3	2	3	1	1	2	12
OG0000500	2	5	1	1	1	2	12
OG0000501	3	1	3	2	2	1	12
OG0000502	2	2	1	3	3	1	12
OG0000503	2	1	3	2	2	2	12
OG0000504	4	1	2	2	2	1	12
OG0000505	3	3	1	2	1	2	12
OG0000506	1	5	0	2	2	2	12
OG0000507	3	0	2	3	2	2	12
OG0000508	1	1	1	1	3	5	12
OG0000509	2	2	2	4	1	1	12
OG0000510	2	4	1	2	1	2	12
OG0000511	3	0	1	3	2	3	12
OG0000512	2	3	1	3	2	1	12
OG0000513	4	4	0	0	3	1	12
OG0000514	1	5	1	2	2	1	12
OG0000515	2	3	3	1	3	0	12
OG0000516	2	4	1	2	1	2	12
OG0000517	3	2	1	2	3	1	12
OG0000518	1	2	1	4	2	2	12
OG0000519	2	1	1	4	2	2	12
OG0000520	3	5	1	2	1	0	12
OG0000521	2	0	2	1	5	2	12
OG0000522	1	5	1	2	2	1	12
OG0000523	1	4	1	2	2	2	12
OG0000524	3	1	2	4	1	1	12
OG0000525	1	4	1	1	3	2	12
OG0000526	2	5	1	2	2	0	12
OG0000527	1	5	2	2	1	1	12
OG0000528	2	3	3	2	2	0	12
OG0000529	3	1	0	8	0	0	12
OG0000530	5	1	2	1	2	1	12
OG0000531	2	4	1	2	1	2	12
OG0000532	1	4	1	1	2	3	12
OG0000533	4	1	1	4	1	1	12
OG0000534	2	0	3	4	1	2	12
OG0000535	8	2	1	0	0	1	12
OG0000536	2	3	1	3	1	2	12
OG0000537	1	5	1	4	1	0	12
OG0000538	3	1	1	3	2	2	12
OG0000539	2	1	1	4	1	3	12
OG0000540	2	2	0	4	3	1	12
OG0000541	5	2	1	1	2	1	12
OG0000542	3	4	2	2	0	1	12
OG0000543	1	4	2	1	3	1	12
OG0000544	2	2	2	0	2	4	12
OG0000545	3	1	1	5	1	1	12
OG0000546	3	4	0	2	1	2	12
OG0000547	4	0	4	1	1	2	12
OG0000548	1	3	1	2	2	3	12
OG0000549	3	2	1	4	1	1	12
OG0000550	1	4	1	1	2	3	12
OG0000551	1	2	1	3	2	3	12
OG0000552	2	2	2	2	2	2	12
OG0000553	2	2	2	2	2	2	12
OG0000554	1	3	1	2	2	3	12
OG0000555	1	1	2	3	2	3	12
OG0000556	3	1	1	1	2	4	12
OG0000557	1	4	1	2	2	2	12
OG0000558	2	1	7	1	0	1	12
OG0000559	1	3	2	3	2	1	12
OG0000560	1	5	2	1	1	2	12
OG0000561	2	2	1	3	2	2	12
OG0000562	1	2	1	1	2	5	12
OG0000563	2	5	1	0	0	4	12
OG0000564	1	0	2	5	3	1	12
OG0000565	1	4	2	4	1	0	12
OG0000566	1	2	2	3	1	3	12
OG0000567	1	2	1	2	2	4	12
OG0000568	3	2	1	0	2	4	12
OG0000569	1	9	1	0	0	1	12
OG0000570	5	3	1	1	1	1	12
OG0000571	2	5	1	2	1	1	12
OG0000572	3	4	1	2	1	1	12
OG0000573	2	1	1	3	0	5	12
OG0000574	1	4	1	3	1	2	12
OG0000575	2	0	1	1	3	5	12
OG0000576	1	1	7	1	1	1	12
OG0000577	2	3	1	2	1	3	12
OG0000578	1	2	1	2	2	4	12
OG0000579	1	5	1	1	1	3	12
OG0000580	4	5	1	1	0	1	12
OG0000581	1	6	1	2	1	1	12
OG0000582	1	2	1	3	3	2	12
OG0000583	2	2	2	4	1	1	12
OG0000584	3	1	1	3	2	2	12
OG0000585	3	3	1	2	1	2	12
OG0000586	1	4	1	1	3	2	12
OG0000587	3	4	1	1	3	0	12
OG0000588	1	3	1	3	2	2	12
OG0000589	1	3	1	1	1	5	12
OG0000590	2	1	2	3	2	2	12
OG0000591	1	5	1	2	2	1	12
OG0000592	2	6	1	1	2	0	12
OG0000593	2	0	2	3	2	3	12
OG0000594	2	1	4	1	3	1	12
OG0000595	2	4	2	2	1	1	12
OG0000596	1	6	1	1	1	2	12
OG0000597	1	4	1	1	1	4	12
OG0000598	1	4	1	2	3	1	12
OG0000599	2	1	2	2	2	3	12
OG0000600	1	1	1	3	2	4	12
OG0000601	1	6	1	1	1	2	12
OG0000602	1	2	1	2	2	4	12
OG0000603	3	2	3	1	1	2	12
OG0000604	1	6	1	2	1	1	12
OG0000605	1	3	1	5	2	0	12
OG0000606	1	3	1	2	1	4	12
OG0000607	1	4	1	3	1	2	12
OG0000608	2	3	2	2	2	1	12
OG0000609	1	3	1	2	2	3	12
OG0000610	1	2	1	3	1	4	12
OG0000611	2	3	1	2	2	2	12
OG0000612	1	3	1	3	2	2	12
OG0000613	1	1	1	2	5	2	12
OG0000614	1	5	1	3	1	1	12
OG0000615	1	2	1	3	3	2	12
OG0000616	1	2	1	2	1	5	12
OG0000617	2	1	3	3	2	1	12
OG0000618	2	5	2	1	1	1	12
OG0000619	1	2	2	1	4	2	12
OG0000620	1	4	1	1	3	2	12
OG0000621	1	5	1	2	2	1	12
OG0000622	1	3	1	2	1	4	12
OG0000623	1	4	1	3	1	2	12
OG0000624	2	2	1	2	3	2	12
OG0000625	1	4	1	2	2	2	12
OG0000626	1	2	1	1	3	4	12
OG0000627	1	4	1	2	2	2	12
OG0000628	1	5	1	2	1	2	12
OG0000629	2	1	4	2	1	2	12
OG0000630	1	1	1	2	5	2	12
OG0000631	1	4	2	2	2	1	12
OG0000632	2	2	2	2	2	2	12
OG0000633	1	2	1	4	2	2	12
OG0000634	2	1	1	2	3	3	12
OG0000635	1	3	1	2	2	3	12
OG0000636	1	3	2	2	1	3	12
OG0000637	1	5	1	3	1	1	12
OG0000638	1	8	1	0	1	1	12
OG0000639	1	5	1	0	1	4	12
OG0000640	1	3	1	2	1	4	12
OG0000641	1	1	2	2	2	4	12
OG0000642	2	1	1	1	3	4	12
OG0000643	1	4	1	2	2	2	12
OG0000644	1	3	1	2	2	3	12
OG0000645	1	5	1	2	1	2	12
OG0000646	1	4	1	3	2	1	12
OG0000647	0	4	0	0	0	8	12
OG0000648	0	3	2	2	1	4	12
OG0000649	0	2	0	6	1	3	12
OG0000650	0	4	4	2	1	1	12
OG0000651	0	5	1	4	1	1	12
OG0000652	0	3	1	1	4	3	12
OG0000653	0	6	1	2	2	1	12
OG0000654	0	2	1	1	6	2	12
OG0000655	0	6	1	3	1	1	12
OG0000656	0	4	1	1	2	4	12
OG0000657	0	6	1	0	2	3	12
OG0000658	0	4	1	5	1	1	12
OG0000659	0	2	1	7	1	1	12
OG0000660	0	1	1	3	5	2	12
OG0000661	0	2	1	5	2	2	12
OG0000662	0	2	1	3	1	5	12
OG0000663	0	1	1	10	0	0	12
OG0000664	0	0	5	0	4	3	12
OG0000665	2	2	1	2	2	2	11
OG0000666	1	3	1	0	2	4	11
OG0000667	4	3	0	2	1	1	11
OG0000668	3	2	1	2	1	2	11
OG0000669	2	3	3	1	1	1	11
OG0000670	1	1	1	2	4	2	11
OG0000671	3	1	1	3	3	0	11
OG0000672	2	1	2	2	1	3	11
OG0000673	2	1	1	1	1	5	11
OG0000674	2	2	1	2	2	2	11
OG0000675	1	2	1	4	1	2	11
OG0000676	2	1	5	1	2	0	11
OG0000677	1	4	1	2	2	1	11
OG0000678	2	5	1	1	1	1	11
OG0000679	1	2	1	3	3	1	11
OG0000680	3	1	3	1	1	2	11
OG0000681	1	5	2	0	1	2	11
OG0000682	1	3	1	1	2	3	11
OG0000683	1	6	1	2	1	0	11
OG0000684	1	5	1	2	1	1	11
OG0000685	1	4	1	3	1	1	11
OG0000686	3	1	1	2	1	3	11
OG0000687	1	2	1	3	2	2	11
OG0000688	1	5	1	2	1	1	11
OG0000689	1	1	1	2	1	5	11
OG0000690	1	4	1	1	2	2	11
OG0000691	2	2	1	1	2	3	11
OG0000692	1	4	1	1	2	2	11
OG0000693	1	4	1	2	2	1	11
OG0000694	1	3	1	1	3	2	11
OG0000695	4	4	1	1	0	1	11
OG0000696	2	2	1	2	3	1	11
OG0000697	9	1	0	1	0	0	11
OG0000698	1	4	1	2	2	1	11
OG0000699	2	3	2	2	1	1	11
OG0000700	1	10	0	0	0	0	11
OG0000701	1	3	1	1	3	2	11
OG0000702	2	2	1	2	1	3	11
OG0000703	3	0	0	8	0	0	11
OG0000704	1	5	1	1	1	2	11
OG0000705	2	3	1	2	2	1	11
OG0000706	1	4	1	2	1	2	11
OG0000707	1	2	1	3	3	1	11
OG0000708	2	3	1	3	1	1	11
OG0000709	1	3	1	2	1	3	11
OG0000710	2	2	2	2	2	1	11
OG0000711	1	4	1	1	2	2	11
OG0000712	1	5	1	2	2	0	11
OG0000713	3	2	2	0	3	1	11
OG0000714	1	3	1	2	2	2	11
OG0000715	2	2	3	1	2	1	11
OG0000716	1	1	1	2	3	3	11
OG0000717	1	4	1	3	2	0	11
OG0000718	1	0	1	2	3	4	11
OG0000719	6	1	3	0	1	0	11
OG0000720	2	2	1	1	3	2	11
OG0000721	2	0	1	3	3	2	11
OG0000722	3	3	1	1	2	1	11
OG0000723	2	2	2	1	3	1	11
OG0000724	2	1	3	1	2	2	11
OG0000725	2	1	1	0	4	3	11
OG0000726	1	1	2	2	1	4	11
OG0000727	1	2	0	3	3	2	11
OG0000728	4	1	1	2	2	1	11
OG0000729	1	3	1	2	2	2	11
OG0000730	1	4	1	3	1	1	11
OG0000731	1	6	1	2	1	0	11
OG0000732	1	4	1	2	2	1	11
OG0000733	1	2	2	2	2	2	11
OG0000734	1	2	2	3	2	1	11
OG0000735	3	1	1	2	2	2	11
OG0000736	2	3	1	2	1	2	11
OG0000737	1	3	1	1	2	3	11
OG0000738	1	2	1	1	1	5	11
OG0000739	1	3	1	2	2	2	11
OG0000740	1	3	1	3	2	1	11
OG0000741	2	4	2	1	1	1	11
OG0000742	2	3	3	1	2	0	11
OG0000743	2	1	1	1	2	4	11
OG0000744	2	1	2	2	2	2	11
OG0000745	1	2	2	3	2	1	11
OG0000746	2	6	1	1	1	0	11
OG0000747	1	2	1	3	1	3	11
OG0000748	1	2	1	3	1	3	11
OG0000749	1	2	1	2	1	4	11
OG0000750	3	2	1	1	2	2	11
OG0000751	1	1	2	1	2	4	11
OG0000752	1	5	0	2	2	1	11
OG0000753	1	4	1	1	3	1	11
OG0000754	1	4	1	2	2	1	11
OG0000755	1	2	2	2	2	2	11
OG0000756	1	2	1	1	2	4	11
OG0000757	1	4	1	1	2	2	11
OG0000758	4	1	3	0	2	1	11
OG0000759	1	1	2	5	1	1	11
OG0000760	1	3	1	0	2	4	11
OG0000761	1	3	1	2	2	2	11
OG0000762	1	1	0	3	4	2	11
OG0000763	1	3	1	3	1	2	11
OG0000764	1	4	1	2	2	1	11
OG0000765	1	4	1	3	1	1	11
OG0000766	2	3	1	3	1	1	11
OG0000767	2	2	2	1	2	2	11
OG0000768	1	6	1	0	2	1	11
OG0000769	3	2	1	2	1	2	11
OG0000770	2	3	1	1	1	3	11
OG0000771	1	1	1	2	2	4	11
OG0000772	2	0	2	2	2	3	11
OG0000773	1	2	1	3	2	2	11
OG0000774	1	3	1	1	4	1	11
OG0000775	1	4	0	4	1	1	11
OG0000776	1	5	1	1	1	2	11
OG0000777	2	2	1	1	3	2	11
OG0000778	1	2	1	2	2	3	11
OG0000779	1	3	1	2	2	2	11
OG0000780	4	2	1	0	2	2	11
OG0000781	2	3	2	1	1	2	11
OG0000782	1	2	1	1	2	4	11
OG0000783	2	2	1	0	3	3	11
OG0000784	2	2	1	1	3	2	11
OG0000785	1	4	1	0	2	3	11
OG0000786	1	4	1	0	4	1	11
OG0000787	1	6	1	0	1	2	11
OG0000788	1	3	1	3	2	1	11
OG0000789	1	1	1	3	3	2	11
OG0000790	1	6	1	1	1	1	11
OG0000791	1	5	0	1	3	1	11
OG0000792	1	2	1	2	2	3	11
OG0000793	1	1	1	1	4	3	11
OG0000794	1	2	1	2	3	2	11
OG0000795	2	2	2	2	1	2	11
OG0000796	1	3	1	1	3	2	11
OG0000797	2	2	1	1	2	3	11
OG0000798	1	3	1	2	2	2	11
OG0000799	1	5	1	1	1	2	11
OG0000800	4	0	2	2	1	2	11
OG0000801	1	2	1	2	1	4	11
OG0000802	2	1	3	2	2	1	11
OG0000803	2	3	1	3	1	1	11
OG0000804	1	4	1	2	2	1	11
OG0000805	1	1	1	1	4	3	11
OG0000806	1	0	1	2	4	3	11
OG0000807	1	1	1	1	2	5	11
OG0000808	1	1	1	4	2	2	11
OG0000809	1	3	1	2	2	2	11
OG0000810	2	3	1	2	1	2	11
OG0000811	1	2	1	2	2	3	11
OG0000812	1	1	3	2	3	1	11
OG0000813	1	5	1	2	1	1	11
OG0000814	1	2	2	2	1	3	11
OG0000815	1	2	1	1	2	4	11
OG0000816	1	5	1	2	1	1	11
OG0000817	4	1	1	3	1	1	11
OG0000818	2	2	1	2	1	3	11
OG0000819	1	1	4	4	1	0	11
OG0000820	1	3	1	2	2	2	11
OG0000821	1	3	1	1	2	3	11
OG0000822	1	7	1	0	1	1	11
OG0000823	2	1	1	2	2	3	11
OG0000824	1	2	1	1	2	4	11
OG0000825	2	4	2	1	1	1	11
OG0000826	1	2	1	4	2	1	11
OG0000827	1	2	1	2	3	2	11
OG0000828	1	4	0	1	1	4	11
OG0000829	2	0	3	2	3	1	11
OG0000830	1	4	2	1	1	2	11
OG0000831	1	2	1	2	2	3	11
OG0000832	2	3	2	4	0	0	11
OG0000833	1	4	1	2	2	1	11
OG0000834	1	1	1	2	3	3	11
OG0000835	3	3	1	1	1	2	11
OG0000836	2	1	1	2	3	2	11
OG0000837	1	2	1	3	1	3	11
OG0000838	2	2	2	2	1	2	11
OG0000839	1	6	1	1	1	1	11
OG0000840	2	1	2	2	2	2	11
OG0000841	2	4	1	2	1	1	11
OG0000842	1	3	2	1	3	1	11
OG0000843	1	5	1	1	2	1	11
OG0000844	2	2	2	2	1	2	11
OG0000845	1	3	1	2	2	2	11
OG0000846	1	1	2	2	0	5	11
OG0000847	1	0	0	1	7	2	11
OG0000848	2	4	1	2	1	1	11
OG0000849	2	2	1	2	1	3	11
OG0000850	1	0	1	5	2	2	11
OG0000851	1	4	1	4	1	0	11
OG0000852	1	3	1	0	2	4	11
OG0000853	1	4	1	1	2	2	11
OG0000854	1	1	2	2	3	2	11
OG0000855	2	4	1	1	1	2	11
OG0000856	1	4	1	2	2	1	11
OG0000857	1	0	0	9	0	1	11
OG0000858	1	0	1	6	2	1	11
OG0000859	1	3	1	2	2	2	11
OG0000860	1	6	0	1	1	2	11
OG0000861	1	2	1	1	3	3	11
OG0000862	1	3	1	2	1	3	11
OG0000863	1	3	1	1	2	3	11
OG0000864	1	5	1	2	0	2	11
OG0000865	1	6	1	1	1	1	11
OG0000866	1	1	1	4	2	2	11
OG0000867	1	3	1	4	1	1	11
OG0000868	1	3	2	1	1	3	11
OG0000869	1	4	1	2	1	2	11
OG0000870	1	4	1	1	2	2	11
OG0000871	1	0	1	2	4	3	11
OG0000872	1	3	1	2	2	2	11
OG0000873	1	3	1	3	1	2	11
OG0000874	1	1	1	2	2	4	11
OG0000875	1	6	1	1	1	1	11
OG0000876	1	2	1	3	2	2	11
OG0000877	1	3	1	2	2	2	11
OG0000878	1	2	2	1	3	2	11
OG0000879	1	4	1	1	3	1	11
OG0000880	1	5	1	2	1	1	11
OG0000881	1	0	1	6	2	1	11
OG0000882	2	3	2	2	1	1	11
OG0000883	1	2	1	2	2	3	11
OG0000884	1	1	1	4	2	2	11
OG0000885	1	4	1	1	1	3	11
OG0000886	1	5	1	2	1	1	11
OG0000887	1	2	1	3	2	2	11
OG0000888	0	1	1	2	5	2	11
OG0000889	0	4	1	2	1	3	11
OG0000890	0	1	4	2	3	1	11
OG0000891	0	6	1	1	2	1	11
OG0000892	0	3	1	1	4	2	11
OG0000893	0	5	1	0	4	1	11
OG0000894	0	4	1	2	2	2	11
OG0000895	0	2	1	4	2	2	11
OG0000896	0	8	0	2	0	1	11
OG0000897	0	5	1	1	2	2	11
OG0000898	0	4	1	1	4	1	11
OG0000899	0	3	3	1	2	2	11
OG0000900	0	2	1	4	3	1	11
OG0000901	0	11	0	0	0	0	11
OG0000902	0	2	1	3	4	1	11
OG0000903	0	3	1	3	1	3	11
OG0000904	0	6	1	2	2	0	11
OG0000905	0	8	0	3	0	0	11
OG0000906	0	2	1	2	3	3	11
OG0000907	0	2	1	3	1	4	11
OG0000908	0	3	1	1	3	3	11
OG0000909	0	6	1	2	1	1	11
OG0000910	0	3	1	3	2	2	11
OG0000911	0	4	1	2	2	2	11
OG0000912	0	5	1	2	1	2	11
OG0000913	0	4	1	0	1	5	11
OG0000914	0	7	0	2	1	1	11
OG0000915	0	5	1	0	1	4	11
OG0000916	0	6	1	3	0	1	11
OG0000917	0	1	5	0	3	2	11
OG0000918	0	7	1	2	1	0	11
OG0000919	0	2	1	1	3	4	11
OG0000920	0	7	0	1	2	1	11
OG0000921	0	1	1	4	3	2	11
OG0000922	0	1	2	5	1	2	11
OG0000923	0	3	1	1	3	3	11
OG0000924	0	0	11	0	0	0	11
OG0000925	0	0	5	0	1	5	11
OG0000926	0	0	2	4	3	2	11
OG0000927	1	6	1	1	1	0	10
OG0000928	2	5	1	1	1	0	10
OG0000929	2	2	1	1	2	2	10
OG0000930	3	0	1	3	1	2	10
OG0000931	3	1	1	2	2	1	10
OG0000932	1	2	1	1	1	4	10
OG0000933	1	2	1	1	2	3	10
OG0000934	1	4	1	0	3	1	10
OG0000935	1	2	3	1	2	1	10
OG0000936	1	4	1	1	1	2	10
OG0000937	2	3	1	2	1	1	10
OG0000938	2	2	1	2	1	2	10
OG0000939	1	1	1	1	1	5	10
OG0000940	2	0	3	1	2	2	10
OG0000941	2	2	1	1	2	2	10
OG0000942	2	2	1	3	1	1	10
OG0000943	2	1	2	2	2	1	10
OG0000944	1	2	1	3	1	2	10
OG0000945	1	3	1	1	3	1	10
OG0000946	1	5	1	0	2	1	10
OG0000947	2	1	3	1	1	2	10
OG0000948	4	2	3	0	0	1	10
OG0000949	1	2	1	1	3	2	10
OG0000950	1	2	2	2	2	1	10
OG0000951	2	3	0	2	1	2	10
OG0000952	3	1	1	1	3	1	10
OG0000953	1	1	1	1	1	5	10
OG0000954	1	2	1	2	1	3	10
OG0000955	2	2	2	1	1	2	10
OG0000956	4	1	1	1	1	2	10
OG0000957	1	2	1	2	2	2	10
OG0000958	2	3	1	1	1	2	10
OG0000959	1	4	1	1	2	1	10
OG0000960	1	2	1	2	2	2	10
OG0000961	3	1	2	1	2	1	10
OG0000962	2	1	3	1	1	2	10
OG0000963	1	3	0	2	2	2	10
OG0000964	3	2	1	1	1	2	10
OG0000965	1	3	1	2	1	2	10
OG0000966	2	0	1	2	3	2	10
OG0000967	3	1	1	2	2	1	10
OG0000968	1	2	2	0	2	3	10
OG0000969	3	2	2	1	1	1	10
OG0000970	1	2	1	2	1	3	10
OG0000971	2	3	1	2	1	1	10
OG0000972	4	1	2	1	1	1	10
OG0000973	2	1	3	1	2	1	10
OG0000974	1	2	1	1	4	1	10
OG0000975	3	1	1	3	1	1	10
OG0000976	1	2	2	2	2	1	10
OG0000977	2	2	1	3	1	1	10
OG0000978	1	3	1	1	2	2	10
OG0000979	1	3	1	2	1	2	10
OG0000980	1	4	1	1	2	1	10
OG0000981	2	3	1	2	1	1	10
OG0000982	1	3	1	3	1	1	10
OG0000983	2	0	1	2	2	3	10
OG0000984	1	3	1	2	2	1	10
OG0000985	2	2	1	1	2	2	10
OG0000986	1	4	1	2	1	1	10
OG0000987	2	0	2	2	2	2	10
OG0000988	1	2	1	3	2	1	10
OG0000989	1	1	3	1	2	2	10
OG0000990	1	3	2	1	1	2	10
OG0000991	2	1	1	2	3	1	10
OG0000992	1	1	2	1	4	1	10
OG0000993	3	1	2	1	1	2	10
OG0000994	4	2	1	1	1	1	10
OG0000995	2	3	2	1	2	0	10
OG0000996	5	0	5	0	0	0	10
OG0000997	3	1	1	1	1	3	10
OG0000998	2	1	1	2	3	1	10
OG0000999	2	1	1	2	2	2	10
OG0001000	1	1	1	1	5	1	10
OG0001001	1	2	2	2	2	1	10
OG0001002	1	4	1	1	1	2	10
OG0001003	1	2	1	2	2	2	10
OG0001004	1	1	1	3	1	3	10
OG0001005	2	2	1	1	2	2	10
OG0001006	1	4	1	2	1	1	10
OG0001007	1	4	1	1	1	2	10
OG0001008	3	2	1	1	2	1	10
OG0001009	1	2	1	2	1	3	10
OG0001010	2	2	1	2	2	1	10
OG0001011	1	3	2	2	1	1	10
OG0001012	5	3	1	1	0	0	10
OG0001013	2	3	1	4	0	0	10
OG0001014	1	2	1	1	2	3	10
OG0001015	3	1	1	4	0	1	10
OG0001016	4	0	2	1	1	2	10
OG0001017	2	1	1	3	1	2	10
OG0001018	1	0	0	4	1	4	10
OG0001019	1	3	1	2	2	1	10
OG0001020	1	3	1	1	2	2	10
OG0001021	1	2	1	1	2	3	10
OG0001022	1	2	1	2	2	2	10
OG0001023	1	1	3	4	1	0	10
OG0001024	1	1	2	1	1	4	10
OG0001025	2	3	2	1	1	1	10
OG0001026	4	1	1	1	1	2	10
OG0001027	1	3	1	2	2	1	10
OG0001028	1	1	3	1	3	1	10
OG0001029	1	2	1	1	2	3	10
OG0001030	1	5	1	1	1	1	10
OG0001031	4	1	1	2	1	1	10
OG0001032	1	4	1	1	2	1	10
OG0001033	2	2	1	2	2	1	10
OG0001034	1	4	1	1	1	2	10
OG0001035	2	0	3	4	1	0	10
OG0001036	1	2	1	2	1	3	10
OG0001037	1	1	1	2	2	3	10
OG0001038	1	1	1	1	3	3	10
OG0001039	2	2	1	2	1	2	10
OG0001040	2	3	1	2	1	1	10
OG0001041	3	2	0	3	1	1	10
OG0001042	1	3	1	1	2	2	10
OG0001043	1	4	1	2	1	1	10
OG0001044	1	3	1	1	2	2	10
OG0001045	2	1	4	1	1	1	10
OG0001046	1	5	1	2	1	0	10
OG0001047	3	3	0	1	3	0	10
OG0001048	1	3	1	2	2	1	10
OG0001049	1	1	8	0	0	0	10
OG0001050	2	1	2	2	2	1	10
OG0001051	1	4	1	0	0	4	10
OG0001052	1	3	1	2	1	2	10
OG0001053	1	3	1	2	2	1	10
OG0001054	2	3	1	2	1	1	10
OG0001055	1	5	2	1	1	0	10
OG0001056	1	2	1	0	3	3	10
OG0001057	3	2	2	1	1	1	10
OG0001058	2	3	2	1	1	1	10
OG0001059	2	2	2	2	1	1	10
OG0001060	1	4	1	1	1	2	10
OG0001061	1	2	1	2	2	2	10
OG0001062	2	3	2	0	1	2	10
OG0001063	1	1	1	4	2	1	10
OG0001064	1	2	3	2	1	1	10
OG0001065	2	3	1	2	1	1	10
OG0001066	1	4	1	1	2	1	10
OG0001067	1	1	2	1	1	4	10
OG0001068	1	1	1	1	3	3	10
OG0001069	2	3	2	1	1	1	10
OG0001070	2	1	1	3	2	1	10
OG0001071	1	3	1	2	2	1	10
OG0001072	1	4	1	2	1	1	10
OG0001073	1	1	2	3	1	2	10
OG0001074	2	2	1	2	1	2	10
OG0001075	2	3	1	0	2	2	10
OG0001076	2	3	2	1	1	1	10
OG0001077	1	2	1	2	3	1	10
OG0001078	1	5	2	0	1	1	10
OG0001079	1	2	1	4	1	1	10
OG0001080	1	1	1	2	3	2	10
OG0001081	1	3	1	2	2	1	10
OG0001082	1	1	1	4	1	2	10
OG0001083	1	0	2	2	2	3	10
OG0001084	1	3	2	1	2	1	10
OG0001085	2	1	1	2	2	2	10
OG0001086	1	1	1	4	1	2	10
OG0001087	1	3	0	2	2	2	10
OG0001088	1	4	1	1	1	2	10
OG0001089	1	2	1	1	2	3	10
OG0001090	1	3	1	2	1	2	10
OG0001091	1	1	1	2	2	3	10
OG0001092	1	0	1	5	2	1	10
OG0001093	1	3	1	4	0	1	10
OG0001094	1	3	1	2	1	2	10
OG0001095	1	2	1	1	2	3	10
OG0001096	1	3	1	2	1	2	10
OG0001097	1	4	1	1	2	1	10
OG0001098	2	1	1	1	3	2	10
OG0001099	1	4	1	1	1	2	10
OG0001100	1	2	1	2	2	2	10
OG0001101	1	4	2	1	0	2	10
OG0001102	1	2	2	3	0	2	10
OG0001103	1	1	2	4	1	1	10
OG0001104	1	3	3	1	1	1	10
OG0001105	1	1	2	4	1	1	10
OG0001106	1	1	3	2	1	2	10
OG0001107	2	2	1	2	1	2	10
OG0001108	1	5	1	1	1	1	10
OG0001109	1	3	1	2	2	1	10
OG0001110	1	2	1	2	2	2	10
OG0001111	1	4	3	1	0	1	10
OG0001112	1	1	1	2	4	1	10
OG0001113	1	2	1	2	2	2	10
OG0001114	1	1	2	1	3	2	10
OG0001115	1	1	1	2	3	2	10
OG0001116	2	2	2	1	1	2	10
OG0001117	1	4	1	1	1	2	10
OG0001118	1	4	1	1	2	1	10
OG0001119	1	1	1	2	3	2	10
OG0001120	3	1	1	1	2	2	10
OG0001121	1	1	1	3	3	1	10
OG0001122	1	1	2	2	1	3	10
OG0001123	1	3	2	2	1	1	10
OG0001124	1	3	1	1	2	2	10
OG0001125	2	3	1	1	1	2	10
OG0001126	1	2	1	1	2	3	10
OG0001127	1	4	1	0	1	3	10
OG0001128	2	3	2	0	1	2	10
OG0001129	1	2	1	2	0	4	10
OG0001130	1	1	1	2	2	3	10
OG0001131	1	4	1	1	1	2	10
OG0001132	1	1	1	2	2	3	10
OG0001133	1	3	1	2	1	2	10
OG0001134	1	4	1	1	2	1	10
OG0001135	1	4	1	1	1	2	10
OG0001136	1	3	1	2	2	1	10
OG0001137	1	5	1	1	0	2	10
OG0001138	1	2	1	2	2	2	10
OG0001139	1	3	1	2	2	1	10
OG0001140	1	3	1	2	1	2	10
OG0001141	1	2	2	1	1	3	10
OG0001142	1	0	1	2	4	2	10
OG0001143	1	2	1	2	1	3	10
OG0001144	1	4	1	2	1	1	10
OG0001145	2	2	1	3	1	1	10
OG0001146	1	1	1	2	3	2	10
OG0001147	1	4	1	2	1	1	10
OG0001148	2	2	1	1	1	3	10
OG0001149	2	1	1	1	3	2	10
OG0001150	1	9	0	0	0	0	10
OG0001151	1	0	2	4	2	1	10
OG0001152	1	2	1	0	1	5	10
OG0001153	1	3	1	1	2	2	10
OG0001154	1	1	1	3	3	1	10
OG0001155	2	0	2	2	2	2	10
OG0001156	1	3	1	0	3	2	10
OG0001157	1	3	1	1	2	2	10
OG0001158	2	1	2	1	3	1	10
OG0001159	1	1	4	2	2	0	10
OG0001160	1	2	1	2	2	2	10
OG0001161	1	1	1	4	2	1	10
OG0001162	1	1	1	1	2	4	10
OG0001163	1	3	1	2	2	1	10
OG0001164	1	3	1	1	2	2	10
OG0001165	1	4	1	1	2	1	10
OG0001166	2	2	1	2	1	2	10
OG0001167	1	1	1	1	2	4	10
OG0001168	2	1	1	1	1	4	10
OG0001169	1	2	1	2	3	1	10
OG0001170	1	2	1	1	2	3	10
OG0001171	1	1	1	4	1	2	10
OG0001172	1	5	1	1	0	2	10
OG0001173	1	3	1	3	1	1	10
OG0001174	1	4	1	1	2	1	10
OG0001175	2	1	2	2	2	1	10
OG0001176	1	3	1	1	2	2	10
OG0001177	1	3	1	0	2	3	10
OG0001178	2	3	1	1	2	1	10
OG0001179	1	2	1	3	1	2	10
OG0001180	1	2	2	2	2	1	10
OG0001181	1	0	1	5	2	1	10
OG0001182	1	1	0	1	3	4	10
OG0001183	1	2	1	2	2	2	10
OG0001184	1	1	1	3	2	2	10
OG0001185	1	3	1	1	1	3	10
OG0001186	1	2	1	4	1	1	10
OG0001187	1	1	1	3	2	2	10
OG0001188	1	2	1	1	2	3	10
OG0001189	1	3	1	1	2	2	10
OG0001190	1	1	1	2	1	4	10
OG0001191	1	2	1	3	1	2	10
OG0001192	1	5	1	1	1	1	10
OG0001193	1	3	1	2	1	2	10
OG0001194	1	4	1	2	1	1	10
OG0001195	2	2	2	0	1	3	10
OG0001196	0	3	1	2	1	3	10
OG0001197	0	2	1	3	3	1	10
OG0001198	0	3	1	2	2	2	10
OG0001199	0	5	1	2	1	1	10
OG0001200	0	3	1	2	2	2	10
OG0001201	0	3	1	1	2	3	10
OG0001202	0	4	2	3	0	1	10
OG0001203	0	4	1	3	1	1	10
OG0001204	0	5	1	1	2	1	10
OG0001205	0	3	1	3	1	2	10
OG0001206	0	1	1	0	4	4	10
OG0001207	0	4	1	2	2	1	10
OG0001208	0	3	0	2	2	3	10
OG0001209	0	4	1	2	1	2	10
OG0001210	0	10	0	0	0	0	10
OG0001211	0	2	1	2	2	3	10
OG0001212	0	3	1	1	2	3	10
OG0001213	0	3	1	3	1	2	10
OG0001214	0	3	3	1	1	2	10
OG0001215	0	3	1	3	1	2	10
OG0001216	0	6	1	0	1	2	10
OG0001217	0	3	1	1	2	3	10
OG0001218	0	5	1	1	2	1	10
OG0001219	0	10	0	0	0	0	10
OG0001220	0	2	0	2	1	5	10
OG0001221	0	3	1	1	5	0	10
OG0001222	0	3	1	2	1	3	10
OG0001223	0	2	1	2	2	3	10
OG0001224	0	3	1	2	2	2	10
OG0001225	0	3	1	1	4	1	10
OG0001226	0	4	1	1	2	2	10
OG0001227	0	2	1	2	1	4	10
OG0001228	0	4	1	2	2	1	10
OG0001229	0	1	1	0	4	4	10
OG0001230	0	5	1	1	2	1	10
OG0001231	0	2	1	2	2	3	10
OG0001232	0	2	2	2	2	2	10
OG0001233	0	1	1	2	3	3	10
OG0001234	0	2	1	1	3	3	10
OG0001235	0	5	1	2	1	1	10
OG0001236	0	6	1	2	1	0	10
OG0001237	0	1	2	2	2	3	10
OG0001238	0	3	2	2	2	1	10
OG0001239	0	1	1	0	2	6	10
OG0001240	0	1	1	4	2	2	10
OG0001241	0	4	1	1	3	1	10
OG0001242	0	2	1	2	3	2	10
OG0001243	0	2	1	1	3	3	10
OG0001244	0	1	1	2	0	6	10
OG0001245	0	1	1	7	0	1	10
OG0001246	0	2	1	5	1	1	10
OG0001247	0	2	0	2	4	2	10
OG0001248	0	2	2	1	2	3	10
OG0001249	0	0	1	0	3	6	10
OG0001250	0	0	0	10	0	0	10
OG0001251	1	3	1	1	2	1	9
OG0001252	3	1	0	5	0	0	9
OG0001253	1	1	1	2	0	4	9
OG0001254	3	0	1	2	2	1	9
OG0001255	3	0	1	2	1	2	9
OG0001256	1	6	0	2	0	0	9
OG0001257	3	2	1	1	1	1	9
OG0001258	2	2	1	0	3	1	9
OG0001259	2	1	0	2	1	3	9
OG0001260	2	1	1	1	2	2	9
OG0001261	4	1	1	1	1	1	9
OG0001262	2	1	1	1	2	2	9
OG0001263	2	1	2	0	1	3	9
OG0001264	2	2	1	1	1	2	9
OG0001265	2	1	1	1	1	3	9
OG0001266	1	1	1	2	2	2	9
OG0001267	2	1	1	2	2	1	9
OG0001268	2	3	1	0	1	2	9
OG0001269	2	0	1	2	1	3	9
OG0001270	3	1	0	1	3	1	9
OG0001271	1	1	2	2	2	1	9
OG0001272	1	1	1	1	1	4	9
OG0001273	1	1	3	0	2	2	9
OG0001274	9	0	0	0	0	0	9
OG0001275	1	3	1	1	2	1	9
OG0001276	1	1	1	1	2	3	9
OG0001277	2	1	1	1	4	0	9
OG0001278	1	2	1	2	1	2	9
OG0001279	2	2	2	1	1	1	9
OG0001280	3	2	1	1	2	0	9
OG0001281	1	3	1	2	1	1	9
OG0001282	2	1	1	3	1	1	9
OG0001283	2	2	2	1	1	1	9
OG0001284	1	2	1	3	1	1	9
OG0001285	2	2	1	0	2	2	9
OG0001286	3	2	0	0	2	2	9
OG0001287	1	3	1	2	1	1	9
OG0001288	3	0	1	2	1	2	9
OG0001289	3	1	1	1	2	1	9
OG0001290	2	1	2	1	2	1	9
OG0001291	1	1	1	3	1	2	9
OG0001292	1	3	1	1	1	2	9
OG0001293	1	2	2	0	3	1	9
OG0001294	1	1	1	1	4	1	9
OG0001295	2	1	1	1	2	2	9
OG0001296	3	1	1	1	1	2	9
OG0001297	1	1	1	1	2	3	9
OG0001298	1	1	1	2	2	2	9
OG0001299	1	3	1	2	1	1	9
OG0001300	1	3	1	1	2	1	9
OG0001301	1	1	3	1	2	1	9
OG0001302	1	4	1	1	1	1	9
OG0001303	3	0	1	2	3	0	9
OG0001304	3	1	2	1	1	1	9
OG0001305	2	0	1	2	2	2	9
OG0001306	2	2	1	2	1	1	9
OG0001307	2	4	0	1	1	1	9
OG0001308	1	1	1	2	2	2	9
OG0001309	3	2	1	0	2	1	9
OG0001310	1	1	2	1	1	3	9
OG0001311	1	4	1	2	0	1	9
OG0001312	2	2	1	2	1	1	9
OG0001313	3	1	1	2	1	1	9
OG0001314	3	1	1	1	1	2	9
OG0001315	4	1	1	0	1	2	9
OG0001316	1	2	2	2	1	1	9
OG0001317	1	3	2	2	0	1	9
OG0001318	1	1	1	1	5	0	9
OG0001319	3	1	1	3	1	0	9
OG0001320	1	3	1	2	1	1	9
OG0001321	2	0	0	5	0	2	9
OG0001322	3	2	1	2	1	0	9
OG0001323	2	4	1	1	1	0	9
OG0001324	1	1	2	2	1	2	9
OG0001325	1	2	1	2	2	1	9
OG0001326	2	1	2	1	2	1	9
OG0001327	1	1	1	1	3	2	9
OG0001328	1	2	1	0	3	2	9
OG0001329	3	1	1	1	0	3	9
OG0001330	1	1	7	0	0	0	9
OG0001331	3	1	2	1	1	1	9
OG0001332	1	1	1	3	1	2	9
OG0001333	1	3	1	1	2	1	9
OG0001334	1	2	1	1	2	2	9
OG0001335	1	4	1	1	1	1	9
OG0001336	3	1	1	1	1	2	9
OG0001337	1	1	1	3	1	2	9
OG0001338	3	1	1	1	2	1	9
OG0001339	1	3	1	2	1	1	9
OG0001340	2	1	1	1	3	1	9
OG0001341	1	2	2	1	2	1	9
OG0001342	1	2	1	2	2	1	9
OG0001343	1	3	1	2	1	1	9
OG0001344	1	1	1	1	1	4	9
OG0001345	1	1	1	1	2	3	9
OG0001346	1	1	1	3	0	3	9
OG0001347	2	1	2	2	2	0	9
OG0001348	1	2	1	2	2	1	9
OG0001349	2	2	1	1	1	2	9
OG0001350	1	3	1	2	1	1	9
OG0001351	1	1	1	4	1	1	9
OG0001352	1	0	8	0	0	0	9
OG0001353	1	0	1	1	0	6	9
OG0001354	1	1	1	2	2	2	9
OG0001355	1	1	1	2	2	2	9
OG0001356	1	2	1	3	1	1	9
OG0001357	3	1	1	2	1	1	9
OG0001358	1	2	1	3	1	1	9
OG0001359	3	2	1	1	1	1	9
OG0001360	1	2	2	2	1	1	9
OG0001361	1	2	1	2	2	1	9
OG0001362	1	1	1	1	4	1	9
OG0001363	2	0	2	2	2	1	9
OG0001364	2	3	1	1	1	1	9
OG0001365	2	0	2	2	2	1	9
OG0001366	1	1	0	2	3	2	9
OG0001367	2	2	1	2	1	1	9
OG0001368	1	4	1	1	1	1	9
OG0001369	2	1	2	1	1	2	9
OG0001370	1	2	1	3	1	1	9
OG0001371	1	3	1	2	1	1	9
OG0001372	1	2	2	2	1	1	9
OG0001373	1	2	1	2	2	1	9
OG0001374	3	1	1	0	2	2	9
OG0001375	1	1	3	2	1	1	9
OG0001376	1	4	1	1	1	1	9
OG0001377	1	1	1	1	2	3	9
OG0001378	1	3	1	1	1	2	9
OG0001379	3	1	1	1	2	1	9
OG0001380	2	1	1	2	2	1	9
OG0001381	1	1	1	2	2	2	9
OG0001382	2	3	1	0	1	2	9
OG0001383	1	3	1	2	1	1	9
OG0001384	1	1	1	3	1	2	9
OG0001385	4	1	1	0	3	0	9
OG0001386	1	3	1	1	2	1	9
OG0001387	1	3	1	2	1	1	9
OG0001388	1	2	1	2	2	1	9
OG0001389	1	2	1	1	2	2	9
OG0001390	1	2	1	1	1	3	9
OG0001391	1	1	1	4	1	1	9
OG0001392	3	1	2	1	1	1	9
OG0001393	1	1	1	2	3	1	9
OG0001394	3	2	1	1	1	1	9
OG0001395	1	3	1	2	1	1	9
OG0001396	1	3	1	2	0	2	9
OG0001397	3	2	1	2	1	0	9
OG0001398	1	2	1	2	1	2	9
OG0001399	1	1	2	2	1	2	9
OG0001400	2	2	1	1	1	2	9
OG0001401	2	2	1	2	1	1	9
OG0001402	2	0	1	1	2	3	9
OG0001403	2	2	1	2	1	1	9
OG0001404	4	1	0	3	1	0	9
OG0001405	1	2	1	0	0	5	9
OG0001406	3	1	1	1	1	2	9
OG0001407	1	2	1	1	2	2	9
OG0001408	2	1	2	0	2	2	9
OG0001409	1	3	2	1	1	1	9
OG0001410	1	1	2	2	2	1	9
OG0001411	3	0	3	1	1	1	9
OG0001412	1	1	1	2	1	3	9
OG0001413	1	4	2	1	1	0	9
OG0001414	1	2	1	3	1	1	9
OG0001415	1	3	1	0	2	2	9
OG0001416	2	2	1	2	1	1	9
OG0001417	1	2	1	1	2	2	9
OG0001418	1	1	1	1	3	2	9
OG0001419	1	0	1	2	3	2	9
OG0001420	3	2	1	1	0	2	9
OG0001421	1	3	2	1	1	1	9
OG0001422	1	2	1	1	2	2	9
OG0001423	1	3	1	1	1	2	9
OG0001424	3	0	1	2	1	2	9
OG0001425	2	2	1	1	0	3	9
OG0001426	1	2	1	2	1	2	9
OG0001427	2	1	3	1	1	1	9
OG0001428	1	5	1	1	1	0	9
OG0001429	3	0	2	0	1	3	9
OG0001430	2	2	1	2	1	1	9
OG0001431	2	1	1	2	1	2	9
OG0001432	3	1	2	1	1	1	9
OG0001433	2	2	1	1	2	1	9
OG0001434	1	2	1	1	2	2	9
OG0001435	1	2	1	3	1	1	9
OG0001436	1	2	2	2	1	1	9
OG0001437	2	3	1	0	2	1	9
OG0001438	1	1	1	3	2	1	9
OG0001439	1	6	1	0	0	1	9
OG0001440	2	2	1	1	2	1	9
OG0001441	2	4	1	1	1	0	9
OG0001442	2	2	2	2	1	0	9
OG0001443	1	2	1	1	2	2	9
OG0001444	2	1	1	2	1	2	9
OG0001445	2	1	2	2	1	1	9
OG0001446	1	4	1	1	0	2	9
OG0001447	3	1	2	1	1	1	9
OG0001448	2	0	1	1	3	2	9
OG0001449	1	3	1	0	2	2	9
OG0001450	2	1	1	0	3	2	9
OG0001451	1	1	1	3	1	2	9
OG0001452	1	1	1	2	2	2	9
OG0001453	1	4	1	1	1	1	9
OG0001454	1	3	1	2	1	1	9
OG0001455	3	0	2	2	2	0	9
OG0001456	1	3	1	1	1	2	9
OG0001457	1	3	1	2	2	0	9
OG0001458	1	1	1	2	2	2	9
OG0001459	1	3	1	2	0	2	9
OG0001460	1	2	1	1	3	1	9
OG0001461	3	2	1	1	1	1	9
OG0001462	1	3	1	1	2	1	9
OG0001463	1	1	1	2	2	2	9
OG0001464	2	1	1	1	1	3	9
OG0001465	2	1	1	3	1	1	9
OG0001466	1	2	1	1	1	3	9
OG0001467	1	1	2	3	1	1	9
OG0001468	1	1	1	0	2	4	9
OG0001469	3	0	3	1	1	1	9
OG0001470	1	2	2	1	2	1	9
OG0001471	2	3	1	1	1	1	9
OG0001472	1	1	1	1	0	5	9
OG0001473	1	2	2	3	0	1	9
OG0001474	1	2	1	2	1	2	9
OG0001475	2	1	2	1	1	2	9
OG0001476	3	1	2	2	0	1	9
OG0001477	1	2	1	2	1	2	9
OG0001478	2	2	1	2	1	1	9
OG0001479	1	0	3	3	1	1	9
OG0001480	1	2	1	2	1	2	9
OG0001481	1	1	1	1	3	2	9
OG0001482	1	2	1	1	2	2	9
OG0001483	1	2	1	2	2	1	9
OG0001484	1	1	1	3	2	1	9
OG0001485	3	1	0	5	0	0	9
OG0001486	2	2	1	1	2	1	9
OG0001487	1	0	0	4	2	2	9
OG0001488	1	2	1	2	1	2	9
OG0001489	3	0	1	3	1	1	9
OG0001490	1	2	2	1	2	1	9
OG0001491	2	0	1	3	2	1	9
OG0001492	2	0	3	0	2	2	9
OG0001493	2	2	1	2	1	1	9
OG0001494	1	2	0	4	0	2	9
OG0001495	1	2	1	1	2	2	9
OG0001496	1	4	1	2	0	1	9
OG0001497	3	1	1	1	2	1	9
OG0001498	1	0	2	2	2	2	9
OG0001499	1	2	1	1	2	2	9
OG0001500	1	1	2	1	2	2	9
OG0001501	1	4	1	1	1	1	9
OG0001502	1	3	2	1	1	1	9
OG0001503	2	1	1	2	2	1	9
OG0001504	1	5	1	1	0	1	9
OG0001505	1	1	1	2	2	2	9
OG0001506	2	1	2	0	1	3	9
OG0001507	1	2	1	1	1	3	9
OG0001508	1	2	2	2	1	1	9
OG0001509	1	0	3	2	1	2	9
OG0001510	1	1	2	3	1	1	9
OG0001511	1	5	1	1	0	1	9
OG0001512	3	1	2	1	1	1	9
OG0001513	1	4	1	1	2	0	9
OG0001514	3	1	1	0	1	3	9
OG0001515	1	2	1	2	1	2	9
OG0001516	1	3	1	3	1	0	9
OG0001517	1	1	1	2	2	2	9
OG0001518	1	4	1	1	1	1	9
OG0001519	1	1	1	2	2	2	9
OG0001520	1	0	1	2	3	2	9
OG0001521	1	2	1	1	2	2	9
OG0001522	2	1	2	2	1	1	9
OG0001523	1	2	1	4	1	0	9
OG0001524	1	2	0	2	3	1	9
OG0001525	1	3	1	1	0	3	9
OG0001526	2	0	2	3	1	1	9
OG0001527	1	2	1	2	2	1	9
OG0001528	2	1	2	1	1	2	9
OG0001529	1	2	1	2	2	1	9
OG0001530	1	3	1	1	1	2	9
OG0001531	1	2	1	3	1	1	9
OG0001532	1	3	1	0	1	3	9
OG0001533	1	1	1	3	1	2	9
OG0001534	1	3	1	2	1	1	9
OG0001535	1	1	1	1	3	2	9
OG0001536	1	2	1	1	1	3	9
OG0001537	2	2	2	1	0	2	9
OG0001538	1	3	1	2	1	1	9
OG0001539	2	0	2	1	3	1	9
OG0001540	1	5	1	2	0	0	9
OG0001541	1	2	1	1	0	4	9
OG0001542	3	1	1	1	2	1	9
OG0001543	1	2	1	3	1	1	9
OG0001544	1	3	1	0	3	1	9
OG0001545	2	1	2	1	1	2	9
OG0001546	1	1	0	1	3	3	9
OG0001547	1	3	1	2	1	1	9
OG0001548	1	1	1	3	1	2	9
OG0001549	1	3	1	1	0	3	9
OG0001550	1	1	1	4	1	1	9
OG0001551	2	1	2	1	1	2	9
OG0001552	1	3	1	2	1	1	9
OG0001553	1	1	1	1	3	2	9
OG0001554	1	3	1	1	1	2	9
OG0001555	1	1	1	2	3	1	9
OG0001556	1	1	2	3	1	1	9
OG0001557	1	1	2	3	1	1	9
OG0001558	1	2	1	2	2	1	9
OG0001559	1	1	1	2	2	2	9
OG0001560	1	1	1	2	1	3	9
OG0001561	1	1	2	1	2	2	9
OG0001562	1	4	1	1	1	1	9
OG0001563	1	0	1	5	1	1	9
OG0001564	1	3	1	1	2	1	9
OG0001565	1	2	1	3	2	0	9
OG0001566	1	1	1	1	2	3	9
OG0001567	1	1	1	1	2	3	9
OG0001568	1	1	1	1	4	1	9
OG0001569	1	1	1	1	2	3	9
OG0001570	1	2	1	2	1	2	9
OG0001571	1	1	1	2	2	2	9
OG0001572	1	1	1	2	1	3	9
OG0001573	1	4	1	2	0	1	9
OG0001574	1	2	0	1	1	4	9
OG0001575	1	0	1	5	1	1	9
OG0001576	1	3	1	2	1	1	9
OG0001577	1	2	1	3	1	1	9
OG0001578	1	2	1	2	1	2	9
OG0001579	1	3	1	1	2	1	9
OG0001580	1	2	1	2	2	1	9
OG0001581	1	4	1	2	0	1	9
OG0001582	2	1	1	2	1	2	9
OG0001583	1	1	1	1	1	4	9
OG0001584	1	1	1	1	2	3	9
OG0001585	1	2	1	2	2	1	9
OG0001586	4	1	1	1	1	1	9
OG0001587	2	1	1	2	1	2	9
OG0001588	1	4	1	2	0	1	9
OG0001589	1	1	2	2	2	1	9
OG0001590	2	1	2	1	1	2	9
OG0001591	1	1	1	1	2	3	9
OG0001592	1	3	1	2	1	1	9
OG0001593	1	4	1	1	0	2	9
OG0001594	1	1	1	2	2	2	9
OG0001595	1	1	1	2	1	3	9
OG0001596	1	3	1	2	1	1	9
OG0001597	3	1	2	2	0	1	9
OG0001598	1	1	1	4	1	1	9
OG0001599	1	3	1	1	2	1	9
OG0001600	2	0	1	2	3	1	9
OG0001601	2	2	1	2	1	1	9
OG0001602	2	1	1	2	1	2	9
OG0001603	1	3	2	2	1	0	9
OG0001604	1	1	2	1	2	2	9
OG0001605	1	0	2	2	1	3	9
OG0001606	1	3	1	2	1	1	9
OG0001607	1	1	1	1	0	5	9
OG0001608	1	3	1	1	1	2	9
OG0001609	1	1	1	4	1	1	9
OG0001610	1	0	1	4	1	2	9
OG0001611	1	2	1	4	1	0	9
OG0001612	2	1	2	1	2	1	9
OG0001613	1	5	1	1	1	0	9
OG0001614	1	1	1	4	1	1	9
OG0001615	1	1	1	3	1	2	9
OG0001616	1	2	1	1	2	2	9
OG0001617	1	1	1	2	3	1	9
OG0001618	1	2	3	1	1	1	9
OG0001619	1	1	1	3	1	2	9
OG0001620	1	1	1	2	2	2	9
OG0001621	1	2	1	1	3	1	9
OG0001622	1	4	1	1	1	1	9
OG0001623	1	1	1	2	1	3	9
OG0001624	1	2	1	2	2	1	9
OG0001625	1	2	1	2	1	2	9
OG0001626	1	1	2	1	2	2	9
OG0001627	2	2	2	1	1	1	9
OG0001628	1	4	1	0	1	2	9
OG0001629	1	4	1	2	1	0	9
OG0001630	2	0	1	3	1	2	9
OG0001631	1	2	1	2	1	2	9
OG0001632	1	3	0	2	1	2	9
OG0001633	1	1	2	1	1	3	9
OG0001634	1	3	1	2	1	1	9
OG0001635	1	1	1	2	1	3	9
OG0001636	1	1	1	1	1	4	9
OG0001637	1	3	1	1	2	1	9
OG0001638	1	1	1	0	5	1	9
OG0001639	1	3	1	1	2	1	9
OG0001640	1	1	1	2	2	2	9
OG0001641	1	1	0	5	1	1	9
OG0001642	1	0	1	1	4	2	9
OG0001643	1	0	1	1	2	4	9
OG0001644	1	2	2	1	1	2	9
OG0001645	1	2	0	3	2	1	9
OG0001646	1	4	1	1	1	1	9
OG0001647	1	1	1	1	2	3	9
OG0001648	2	1	1	1	2	2	9
OG0001649	2	1	1	0	3	2	9
OG0001650	1	3	1	1	2	1	9
OG0001651	1	4	1	0	3	0	9
OG0001652	1	3	0	2	2	1	9
OG0001653	1	3	1	2	1	1	9
OG0001654	1	3	1	1	2	1	9
OG0001655	1	1	1	2	2	2	9
OG0001656	1	4	1	1	1	1	9
OG0001657	1	4	1	1	1	1	9
OG0001658	1	1	1	4	0	2	9
OG0001659	0	1	1	1	1	5	9
OG0001660	0	1	1	1	2	4	9
OG0001661	0	4	1	2	1	1	9
OG0001662	0	2	1	3	1	2	9
OG0001663	0	1	1	2	2	3	9
OG0001664	0	3	1	1	2	2	9
OG0001665	0	4	1	1	1	2	9
OG0001666	0	2	1	3	1	2	9
OG0001667	0	2	1	2	2	2	9
OG0001668	0	1	1	4	1	2	9
OG0001669	0	3	1	1	1	3	9
OG0001670	0	3	0	3	1	2	9
OG0001671	0	1	2	1	2	3	9
OG0001672	0	3	1	1	2	2	9
OG0001673	0	4	1	2	1	1	9
OG0001674	0	3	2	2	1	1	9
OG0001675	0	1	1	1	4	2	9
OG0001676	0	2	1	1	2	3	9
OG0001677	0	2	1	3	1	2	9
OG0001678	0	2	1	1	3	2	9
OG0001679	0	2	1	2	2	2	9
OG0001680	0	3	1	3	1	1	9
OG0001681	0	3	1	1	2	2	9
OG0001682	0	2	0	5	1	1	9
OG0001683	0	2	1	0	1	5	9
OG0001684	0	2	1	0	2	4	9
OG0001685	0	1	1	3	2	2	9
OG0001686	0	1	1	2	2	3	9
OG0001687	0	2	1	2	2	2	9
OG0001688	0	3	1	1	2	2	9
OG0001689	0	2	2	1	2	2	9
OG0001690	0	4	1	1	2	1	9
OG0001691	0	3	1	1	1	3	9
OG0001692	0	3	0	1	1	4	9
OG0001693	0	2	1	2	3	1	9
OG0001694	0	2	1	3	2	1	9
OG0001695	0	3	1	1	3	1	9
OG0001696	0	2	1	1	3	2	9
OG0001697	0	2	1	2	2	2	9
OG0001698	0	4	1	0	2	2	9
OG0001699	0	1	2	1	1	4	9
OG0001700	0	3	1	0	2	3	9
OG0001701	0	1	2	5	0	1	9
OG0001702	0	3	1	1	2	2	9
OG0001703	0	5	1	1	1	1	9
OG0001704	0	5	1	0	1	2	9
OG0001705	0	3	1	1	2	2	9
OG0001706	0	5	1	1	1	1	9
OG0001707	0	2	1	1	3	2	9
OG0001708	0	2	1	3	1	2	9
OG0001709	0	2	1	2	2	2	9
OG0001710	0	4	1	1	1	2	9
OG0001711	0	1	2	1	2	3	9
OG0001712	0	5	1	1	1	1	9
OG0001713	0	2	1	2	1	3	9
OG0001714	0	2	1	1	2	3	9
OG0001715	0	3	1	1	1	3	9
OG0001716	0	1	2	3	1	2	9
OG0001717	0	1	1	5	1	1	9
OG0001718	0	3	1	4	1	0	9
OG0001719	0	5	1	1	1	1	9
OG0001720	0	5	1	1	0	2	9
OG0001721	0	0	9	0	0	0	9
OG0001722	0	0	3	1	3	2	9
OG0001723	0	0	9	0	0	0	9
OG0001724	0	0	1	0	0	8	9
OG0001725	0	0	0	9	0	0	9
OG0001726	0	0	0	9	0	0	9
OG0001727	0	0	0	0	6	3	9
OG0001728	0	0	0	0	9	0	9
OG0001729	2	2	1	1	1	1	8
OG0001730	3	1	1	1	1	1	8
OG0001731	3	1	1	1	1	1	8
OG0001732	2	0	2	2	1	1	8
OG0001733	1	3	1	1	1	1	8
OG0001734	1	2	1	1	2	1	8
OG0001735	1	2	0	1	3	1	8
OG0001736	1	1	1	1	2	2	8
OG0001737	1	0	1	3	1	2	8
OG0001738	3	0	1	2	1	1	8
OG0001739	1	2	1	1	2	1	8
OG0001740	2	2	2	0	1	1	8
OG0001741	1	2	1	2	1	1	8
OG0001742	1	2	2	1	1	1	8
OG0001743	1	2	1	2	1	1	8
OG0001744	2	1	1	2	1	1	8
OG0001745	2	0	1	3	1	1	8
OG0001746	2	1	1	2	1	1	8
OG0001747	1	2	1	2	1	1	8
OG0001748	2	3	1	2	0	0	8
OG0001749	2	5	0	0	0	1	8
OG0001750	1	2	1	1	1	2	8
OG0001751	3	2	1	1	1	0	8
OG0001752	8	0	0	0	0	0	8
OG0001753	2	0	1	1	2	2	8
OG0001754	2	1	1	2	1	1	8
OG0001755	1	2	1	1	2	1	8
OG0001756	1	3	1	0	1	2	8
OG0001757	1	1	1	3	1	1	8
OG0001758	3	1	1	1	1	1	8
OG0001759	1	1	1	2	2	1	8
OG0001760	3	0	1	1	2	1	8
OG0001761	3	1	2	0	1	1	8
OG0001762	1	2	1	2	1	1	8
OG0001763	1	2	1	1	2	1	8
OG0001764	1	1	1	1	2	2	8
OG0001765	2	1	1	2	1	1	8
OG0001766	1	3	1	1	1	1	8
OG0001767	1	2	1	1	2	1	8
OG0001768	2	2	1	1	1	1	8
OG0001769	2	3	1	1	0	1	8
OG0001770	2	2	1	1	1	1	8
OG0001771	2	1	1	2	1	1	8
OG0001772	1	0	1	3	1	2	8
OG0001773	2	1	1	2	1	1	8
OG0001774	1	0	1	2	1	3	8
OG0001775	1	3	1	1	1	1	8
OG0001776	1	0	1	2	2	2	8
OG0001777	2	2	0	2	1	1	8
OG0001778	2	2	1	2	0	1	8
OG0001779	1	3	1	1	1	1	8
OG0001780	3	0	1	2	1	1	8
OG0001781	1	2	2	1	1	1	8
OG0001782	2	2	1	2	1	0	8
OG0001783	2	0	1	1	2	2	8
OG0001784	2	0	2	1	2	1	8
OG0001785	2	1	2	1	0	2	8
OG0001786	2	1	1	2	1	1	8
OG0001787	1	2	1	1	2	1	8
OG0001788	1	1	2	1	2	1	8
OG0001789	2	1	1	1	1	2	8
OG0001790	1	5	0	1	0	1	8
OG0001791	3	3	1	1	0	0	8
OG0001792	3	1	1	1	1	1	8
OG0001793	2	1	1	1	1	2	8
OG0001794	1	1	1	1	2	2	8
OG0001795	1	0	2	2	2	1	8
OG0001796	2	2	1	1	0	2	8
OG0001797	1	3	1	2	0	1	8
OG0001798	2	1	1	2	2	0	8
OG0001799	1	1	1	2	2	1	8
OG0001800	1	2	1	2	1	1	8
OG0001801	8	0	0	0	0	0	8
OG0001802	2	1	1	1	1	2	8
OG0001803	5	3	0	0	0	0	8
OG0001804	1	2	1	1	1	2	8
OG0001805	1	3	1	1	1	1	8
OG0001806	1	3	1	1	1	1	8
OG0001807	2	3	1	0	1	1	8
OG0001808	1	1	1	3	1	1	8
OG0001809	2	0	1	1	1	3	8
OG0001810	1	2	1	1	2	1	8
OG0001811	1	2	1	3	1	0	8
OG0001812	2	1	2	1	1	1	8
OG0001813	4	0	2	1	1	0	8
OG0001814	3	1	1	1	1	1	8
OG0001815	1	1	1	1	2	2	8
OG0001816	1	1	1	3	1	1	8
OG0001817	2	0	2	1	2	1	8
OG0001818	1	2	1	1	2	1	8
OG0001819	1	2	1	1	1	2	8
OG0001820	1	1	1	1	2	2	8
OG0001821	1	3	1	2	1	0	8
OG0001822	1	1	2	2	1	1	8
OG0001823	1	2	1	1	2	1	8
OG0001824	1	2	1	1	1	2	8
OG0001825	1	0	5	1	0	1	8
OG0001826	1	3	1	1	1	1	8
OG0001827	1	2	1	2	1	1	8
OG0001828	1	2	1	1	1	2	8
OG0001829	1	1	2	1	1	2	8
OG0001830	1	1	1	2	2	1	8
OG0001831	1	2	1	1	2	1	8
OG0001832	2	4	1	1	0	0	8
OG0001833	2	3	1	1	0	1	8
OG0001834	1	2	1	1	1	2	8
OG0001835	4	0	1	1	1	1	8
OG0001836	2	1	1	2	1	1	8
OG0001837	1	1	1	2	1	2	8
OG0001838	1	4	1	1	1	0	8
OG0001839	1	2	1	1	2	1	8
OG0001840	2	1	1	2	1	1	8
OG0001841	1	2	1	1	2	1	8
OG0001842	1	3	1	1	1	1	8
OG0001843	2	1	1	2	1	1	8
OG0001844	1	2	1	1	1	2	8
OG0001845	1	1	1	1	2	2	8
OG0001846	1	1	1	1	2	2	8
OG0001847	2	1	1	1	2	1	8
OG0001848	1	1	1	2	1	2	8
OG0001849	2	1	2	3	0	0	8
OG0001850	1	1	1	1	2	2	8
OG0001851	3	0	1	2	2	0	8
OG0001852	1	1	0	2	1	3	8
OG0001853	1	1	1	1	2	2	8
OG0001854	1	1	1	3	1	1	8
OG0001855	1	2	1	1	2	1	8
OG0001856	1	2	1	1	1	2	8
OG0001857	3	1	1	1	1	1	8
OG0001858	2	2	1	1	1	1	8
OG0001859	2	1	1	1	2	1	8
OG0001860	1	2	0	1	2	2	8
OG0001861	1	3	1	1	1	1	8
OG0001862	5	1	1	0	0	1	8
OG0001863	1	3	1	1	1	1	8
OG0001864	2	0	1	1	2	2	8
OG0001865	1	4	0	1	0	2	8
OG0001866	2	2	1	0	2	1	8
OG0001867	3	0	2	1	1	1	8
OG0001868	2	2	1	1	1	1	8
OG0001869	2	3	1	1	1	0	8
OG0001870	1	1	1	2	1	2	8
OG0001871	2	1	1	1	1	2	8
OG0001872	2	1	2	1	1	1	8
OG0001873	1	3	1	0	1	2	8
OG0001874	2	1	1	1	2	1	8
OG0001875	1	3	1	2	1	0	8
OG0001876	2	1	0	3	1	1	8
OG0001877	2	0	1	2	1	2	8
OG0001878	2	2	1	1	1	1	8
OG0001879	1	1	1	2	1	2	8
OG0001880	1	4	1	1	0	1	8
OG0001881	1	0	1	2	1	3	8
OG0001882	1	2	1	2	1	1	8
OG0001883	1	4	1	1	1	0	8
OG0001884	1	2	1	2	1	1	8
OG0001885	1	2	1	0	2	2	8
OG0001886	1	1	2	2	1	1	8
OG0001887	2	1	1	2	1	1	8
OG0001888	1	3	1	1	1	1	8
OG0001889	1	1	1	2	1	2	8
OG0001890	1	2	1	1	2	1	8
OG0001891	1	1	1	2	1	2	8
OG0001892	1	1	1	2	1	2	8
OG0001893	1	2	1	1	2	1	8
OG0001894	1	3	1	1	1	1	8
OG0001895	3	2	2	0	0	1	8
OG0001896	1	4	1	0	1	1	8
OG0001897	2	1	1	4	0	0	8
OG0001898	2	1	0	1	2	2	8
OG0001899	1	3	0	1	1	2	8
OG0001900	2	1	2	1	1	1	8
OG0001901	2	2	1	2	1	0	8
OG0001902	2	2	1	1	1	1	8
OG0001903	1	1	1	1	2	2	8
OG0001904	1	1	1	1	2	2	8
OG0001905	1	2	1	1	1	2	8
OG0001906	1	3	1	2	1	0	8
OG0001907	1	2	1	1	1	2	8
OG0001908	1	0	1	2	2	2	8
OG0001909	1	1	1	4	1	0	8
OG0001910	2	1	1	1	1	2	8
OG0001911	2	1	1	1	2	1	8
OG0001912	1	1	2	1	1	2	8
OG0001913	1	1	0	2	2	2	8
OG0001914	1	3	1	0	2	1	8
OG0001915	1	2	1	1	2	1	8
OG0001916	1	0	1	2	3	1	8
OG0001917	1	3	2	0	1	1	8
OG0001918	1	5	1	0	1	0	8
OG0001919	1	1	1	2	2	1	8
OG0001920	2	3	1	0	2	0	8
OG0001921	1	2	0	1	2	2	8
OG0001922	3	1	1	1	1	1	8
OG0001923	1	1	1	1	0	4	8
OG0001924	1	1	1	2	1	2	8
OG0001925	1	1	1	3	0	2	8
OG0001926	1	2	1	1	1	2	8
OG0001927	1	1	0	4	1	1	8
OG0001928	1	2	2	1	1	1	8
OG0001929	1	0	1	5	1	0	8
OG0001930	2	2	1	0	2	1	8
OG0001931	2	1	1	1	2	1	8
OG0001932	1	2	1	2	1	1	8
OG0001933	1	1	1	2	2	1	8
OG0001934	3	1	1	1	1	1	8
OG0001935	3	0	1	1	2	1	8
OG0001936	2	4	0	1	0	1	8
OG0001937	2	2	1	1	1	1	8
OG0001938	5	1	1	1	0	0	8
OG0001939	1	1	1	1	0	4	8
OG0001940	1	2	1	3	0	1	8
OG0001941	6	0	1	1	0	0	8
OG0001942	1	1	1	1	2	2	8
OG0001943	1	1	1	2	2	1	8
OG0001944	1	2	1	1	1	2	8
OG0001945	1	1	1	1	2	2	8
OG0001946	1	0	1	3	1	2	8
OG0001947	1	3	1	1	2	0	8
OG0001948	1	0	1	2	3	1	8
OG0001949	1	2	1	3	0	1	8
OG0001950	1	3	1	1	1	1	8
OG0001951	2	1	3	1	0	1	8
OG0001952	1	3	1	1	1	1	8
OG0001953	1	2	1	1	1	2	8
OG0001954	1	1	2	2	1	1	8
OG0001955	1	1	1	3	1	1	8
OG0001956	1	2	0	1	2	2	8
OG0001957	1	2	1	2	1	1	8
OG0001958	1	4	1	0	0	2	8
OG0001959	2	1	1	2	2	0	8
OG0001960	2	2	1	1	1	1	8
OG0001961	2	1	1	2	1	1	8
OG0001962	1	2	1	1	1	2	8
OG0001963	1	3	1	1	1	1	8
OG0001964	1	1	1	3	1	1	8
OG0001965	1	2	1	2	1	1	8
OG0001966	2	1	2	1	1	1	8
OG0001967	3	0	1	2	1	1	8
OG0001968	1	0	3	2	2	0	8
OG0001969	2	0	1	0	2	3	8
OG0001970	1	3	1	1	2	0	8
OG0001971	1	1	1	2	2	1	8
OG0001972	1	2	1	2	1	1	8
OG0001973	2	1	1	1	1	2	8
OG0001974	2	2	1	1	1	1	8
OG0001975	2	1	1	1	1	2	8
OG0001976	2	0	1	2	1	2	8
OG0001977	1	1	1	2	1	2	8
OG0001978	2	0	1	1	2	2	8
OG0001979	2	0	1	1	1	3	8
OG0001980	1	2	1	2	1	1	8
OG0001981	2	1	1	1	2	1	8
OG0001982	1	1	1	1	1	3	8
OG0001983	1	1	1	1	1	3	8
OG0001984	1	1	2	0	3	1	8
OG0001985	1	1	2	1	1	2	8
OG0001986	1	2	1	2	1	1	8
OG0001987	1	3	1	1	1	1	8
OG0001988	1	2	1	2	1	1	8
OG0001989	2	0	1	1	2	2	8
OG0001990	2	1	1	2	1	1	8
OG0001991	1	1	1	2	2	1	8
OG0001992	1	1	1	2	2	1	8
OG0001993	1	3	2	0	1	1	8
OG0001994	1	2	1	1	2	1	8
OG0001995	3	1	1	1	1	1	8
OG0001996	2	2	1	1	1	1	8
OG0001997	1	1	1	2	1	2	8
OG0001998	1	2	1	1	2	1	8
OG0001999	1	1	2	2	1	1	8
OG0002000	1	3	1	0	1	2	8
OG0002001	2	2	1	1	1	1	8
OG0002002	1	2	1	1	2	1	8
OG0002003	2	1	1	1	1	2	8
OG0002004	1	3	1	2	0	1	8
OG0002005	1	2	1	2	1	1	8
OG0002006	1	1	3	1	1	1	8
OG0002007	3	2	1	1	1	0	8
OG0002008	1	1	1	1	1	3	8
OG0002009	4	1	2	1	0	0	8
OG0002010	2	1	1	1	2	1	8
OG0002011	1	2	1	1	1	2	8
OG0002012	1	3	1	0	2	1	8
OG0002013	1	3	1	0	2	1	8
OG0002014	1	1	1	1	3	1	8
OG0002015	3	1	1	1	1	1	8
OG0002016	2	3	2	1	0	0	8
OG0002017	2	1	1	2	1	1	8
OG0002018	1	1	1	1	2	2	8
OG0002019	1	1	1	1	2	2	8
OG0002020	1	0	0	2	2	3	8
OG0002021	1	2	1	1	1	2	8
OG0002022	1	1	1	2	3	0	8
OG0002023	2	0	1	2	1	2	8
OG0002024	1	1	1	1	2	2	8
OG0002025	1	1	2	1	2	1	8
OG0002026	1	3	1	1	1	1	8
OG0002027	1	2	1	2	1	1	8
OG0002028	1	2	1	2	1	1	8
OG0002029	2	2	1	2	0	1	8
OG0002030	1	1	1	3	1	1	8
OG0002031	1	2	1	1	3	0	8
OG0002032	1	0	0	2	2	3	8
OG0002033	1	1	1	1	1	3	8
OG0002034	2	2	1	1	0	2	8
OG0002035	1	1	1	2	1	2	8
OG0002036	2	1	1	2	1	1	8
OG0002037	1	1	1	3	1	1	8
OG0002038	1	0	0	5	1	1	8
OG0002039	1	3	1	1	1	1	8
OG0002040	1	2	1	2	1	1	8
OG0002041	1	1	1	2	2	1	8
OG0002042	1	3	1	2	0	1	8
OG0002043	1	0	1	1	2	3	8
OG0002044	2	1	1	2	1	1	8
OG0002045	1	2	1	2	1	1	8
OG0002046	2	1	1	1	2	1	8
OG0002047	3	1	1	0	1	2	8
OG0002048	1	1	2	1	1	2	8
OG0002049	1	3	1	1	1	1	8
OG0002050	1	0	1	2	3	1	8
OG0002051	1	3	1	2	1	0	8
OG0002052	1	2	1	1	1	2	8
OG0002053	1	2	1	2	1	1	8
OG0002054	1	2	1	1	1	2	8
OG0002055	2	2	1	1	1	1	8
OG0002056	1	2	1	1	2	1	8
OG0002057	1	2	1	2	1	1	8
OG0002058	1	1	1	2	1	2	8
OG0002059	1	1	1	2	2	1	8
OG0002060	4	2	0	0	1	1	8
OG0002061	1	0	1	2	1	3	8
OG0002062	1	1	1	2	2	1	8
OG0002063	1	1	1	1	2	2	8
OG0002064	1	2	1	2	2	0	8
OG0002065	1	1	1	3	1	1	8
OG0002066	1	1	1	1	3	1	8
OG0002067	1	1	1	1	2	2	8
OG0002068	2	2	1	0	1	2	8
OG0002069	1	0	1	5	0	1	8
OG0002070	1	3	1	1	1	1	8
OG0002071	1	1	1	1	3	1	8
OG0002072	2	3	1	0	1	1	8
OG0002073	2	3	1	1	0	1	8
OG0002074	1	0	1	1	3	2	8
OG0002075	1	0	1	1	2	3	8
OG0002076	1	1	1	2	1	2	8
OG0002077	1	0	1	2	3	1	8
OG0002078	2	0	1	1	2	2	8
OG0002079	2	2	1	1	1	1	8
OG0002080	3	1	1	0	2	1	8
OG0002081	1	4	1	0	1	1	8
OG0002082	4	0	2	1	1	0	8
OG0002083	1	2	1	1	1	2	8
OG0002084	1	1	1	1	1	3	8
OG0002085	1	1	1	1	4	0	8
OG0002086	1	2	1	1	1	2	8
OG0002087	2	1	2	1	1	1	8
OG0002088	1	1	1	1	3	1	8
OG0002089	1	1	1	2	1	2	8
OG0002090	1	2	1	1	1	2	8
OG0002091	1	1	1	1	2	2	8
OG0002092	1	1	1	2	2	1	8
OG0002093	2	3	1	1	1	0	8
OG0002094	1	2	0	2	2	1	8
OG0002095	2	3	0	1	1	1	8
OG0002096	1	1	1	2	2	1	8
OG0002097	1	0	1	2	3	1	8
OG0002098	1	1	1	1	2	2	8
OG0002099	1	1	1	2	2	1	8
OG0002100	1	1	1	2	2	1	8
OG0002101	1	1	1	1	2	2	8
OG0002102	1	1	1	2	1	2	8
OG0002103	1	1	1	2	1	2	8
OG0002104	1	2	1	2	1	1	8
OG0002105	1	3	1	1	1	1	8
OG0002106	1	1	1	1	2	2	8
OG0002107	1	2	1	2	1	1	8
OG0002108	1	1	1	1	2	2	8
OG0002109	2	1	3	1	1	0	8
OG0002110	1	2	1	2	1	1	8
OG0002111	1	1	1	2	2	1	8
OG0002112	1	3	1	1	1	1	8
OG0002113	1	1	1	1	2	2	8
OG0002114	2	3	2	0	0	1	8
OG0002115	1	4	1	0	2	0	8
OG0002116	3	1	1	1	1	1	8
OG0002117	1	1	1	3	1	1	8
OG0002118	1	1	1	2	1	2	8
OG0002119	1	3	1	1	1	1	8
OG0002120	1	1	1	1	1	3	8
OG0002121	1	3	1	2	0	1	8
OG0002122	1	1	1	2	2	1	8
OG0002123	2	1	1	2	1	1	8
OG0002124	1	1	1	2	2	1	8
OG0002125	1	2	1	2	0	2	8
OG0002126	2	1	1	0	2	2	8
OG0002127	3	1	1	2	1	0	8
OG0002128	2	1	1	1	1	2	8
OG0002129	1	3	1	1	1	1	8
OG0002130	3	1	1	2	1	0	8
OG0002131	1	2	1	1	1	2	8
OG0002132	1	2	2	1	1	1	8
OG0002133	1	1	1	1	2	2	8
OG0002134	2	1	1	1	2	1	8
OG0002135	1	1	1	1	2	2	8
OG0002136	1	2	1	2	1	1	8
OG0002137	2	2	1	0	2	1	8
OG0002138	1	0	2	3	1	1	8
OG0002139	1	3	1	0	1	2	8
OG0002140	1	4	1	2	0	0	8
OG0002141	1	0	1	0	2	4	8
OG0002142	1	2	2	1	1	1	8
OG0002143	1	3	1	1	1	1	8
OG0002144	1	1	1	3	2	0	8
OG0002145	1	2	1	1	1	2	8
OG0002146	1	0	1	1	2	3	8
OG0002147	1	2	1	1	1	2	8
OG0002148	1	1	1	1	2	2	8
OG0002149	2	1	2	1	1	1	8
OG0002150	1	2	1	1	2	1	8
OG0002151	1	1	1	0	2	3	8
OG0002152	1	0	2	1	1	3	8
OG0002153	1	1	1	2	2	1	8
OG0002154	1	4	1	1	1	0	8
OG0002155	1	4	1	1	0	1	8
OG0002156	1	3	1	2	1	0	8
OG0002157	1	3	1	0	1	2	8
OG0002158	2	1	1	2	1	1	8
OG0002159	1	0	1	3	1	2	8
OG0002160	1	2	1	1	1	2	8
OG0002161	2	1	1	1	2	1	8
OG0002162	1	1	3	1	1	1	8
OG0002163	1	2	2	1	1	1	8
OG0002164	1	1	1	1	2	2	8
OG0002165	2	2	1	1	1	1	8
OG0002166	2	2	2	0	0	2	8
OG0002167	1	0	3	1	2	1	8
OG0002168	1	0	1	1	2	3	8
OG0002169	1	3	1	1	2	0	8
OG0002170	1	2	1	2	2	0	8
OG0002171	1	4	1	0	1	1	8
OG0002172	2	3	1	0	1	1	8
OG0002173	1	2	1	1	2	1	8
OG0002174	1	2	1	1	0	3	8
OG0002175	2	2	1	1	1	1	8
OG0002176	1	1	1	2	2	1	8
OG0002177	1	3	1	1	1	1	8
OG0002178	2	1	2	1	1	1	8
OG0002179	1	1	2	1	1	2	8
OG0002180	1	3	1	1	1	1	8
OG0002181	1	1	1	1	3	1	8
OG0002182	1	3	1	1	1	1	8
OG0002183	1	2	1	2	1	1	8
OG0002184	1	2	1	1	1	2	8
OG0002185	2	2	1	1	1	1	8
OG0002186	3	3	0	0	1	1	8
OG0002187	2	1	1	2	1	1	8
OG0002188	2	3	1	1	1	0	8
OG0002189	1	1	2	2	1	1	8
OG0002190	1	2	1	1	1	2	8
OG0002191	1	1	3	1	1	1	8
OG0002192	2	1	1	2	1	1	8
OG0002193	1	4	1	1	0	1	8
OG0002194	1	0	2	2	2	1	8
OG0002195	1	1	1	2	1	2	8
OG0002196	1	3	1	1	1	1	8
OG0002197	2	1	1	1	2	1	8
OG0002198	1	2	2	1	1	1	8
OG0002199	1	2	1	1	1	2	8
OG0002200	1	4	1	1	1	0	8
OG0002201	1	1	2	1	1	2	8
OG0002202	1	3	1	1	1	1	8
OG0002203	2	0	1	2	1	2	8
OG0002204	1	2	1	2	1	1	8
OG0002205	1	1	1	2	2	1	8
OG0002206	1	3	1	2	0	1	8
OG0002207	1	2	1	1	1	2	8
OG0002208	1	1	1	2	2	1	8
OG0002209	1	2	1	2	1	1	8
OG0002210	1	0	2	2	1	2	8
OG0002211	1	1	1	1	2	2	8
OG0002212	1	1	1	3	1	1	8
OG0002213	1	0	1	3	1	2	8
OG0002214	1	0	1	2	1	3	8
OG0002215	1	1	1	4	1	0	8
OG0002216	1	0	1	1	3	2	8
OG0002217	1	1	1	1	2	2	8
OG0002218	1	3	1	1	1	1	8
OG0002219	1	1	1	1	2	2	8
OG0002220	2	1	1	1	1	2	8
OG0002221	1	2	1	0	3	1	8
OG0002222	1	1	1	3	1	1	8
OG0002223	1	2	1	1	1	2	8
OG0002224	1	2	2	2	1	0	8
OG0002225	1	1	1	1	1	3	8
OG0002226	1	2	1	2	1	1	8
OG0002227	1	4	1	1	0	1	8
OG0002228	1	0	1	2	1	3	8
OG0002229	1	1	1	3	2	0	8
OG0002230	1	3	1	1	1	1	8
OG0002231	1	5	1	0	0	1	8
OG0002232	1	2	1	1	2	1	8
OG0002233	1	1	2	3	0	1	8
OG0002234	1	3	1	1	0	2	8
OG0002235	1	2	1	1	2	1	8
OG0002236	1	3	1	2	1	0	8
OG0002237	1	3	1	1	0	2	8
OG0002238	1	2	2	1	2	0	8
OG0002239	1	2	1	2	1	1	8
OG0002240	1	1	1	3	1	1	8
OG0002241	2	1	0	3	1	1	8
OG0002242	1	2	1	2	1	1	8
OG0002243	1	4	1	0	1	1	8
OG0002244	1	1	1	2	2	1	8
OG0002245	1	2	1	1	2	1	8
OG0002246	1	2	1	2	1	1	8
OG0002247	1	0	1	3	1	2	8
OG0002248	1	1	1	2	1	2	8
OG0002249	1	2	1	1	1	2	8
OG0002250	1	2	1	0	3	1	8
OG0002251	1	2	1	2	1	1	8
OG0002252	1	1	2	1	1	2	8
OG0002253	1	0	1	3	1	2	8
OG0002254	1	2	1	3	0	1	8
OG0002255	1	2	2	1	2	0	8
OG0002256	1	2	1	3	0	1	8
OG0002257	1	1	1	1	2	2	8
OG0002258	1	1	2	1	1	2	8
OG0002259	1	1	1	3	1	1	8
OG0002260	1	3	1	1	1	1	8
OG0002261	1	1	1	3	2	0	8
OG0002262	1	1	1	2	1	2	8
OG0002263	1	0	1	5	1	0	8
OG0002264	1	2	1	1	1	2	8
OG0002265	1	3	1	1	1	1	8
OG0002266	1	2	2	0	2	1	8
OG0002267	1	2	2	1	2	0	8
OG0002268	1	2	1	2	1	1	8
OG0002269	1	3	1	1	1	1	8
OG0002270	2	1	1	1	2	1	8
OG0002271	1	1	1	2	1	2	8
OG0002272	1	3	1	1	1	1	8
OG0002273	1	1	0	2	1	3	8
OG0002274	1	1	1	1	2	2	8
OG0002275	1	2	1	2	1	1	8
OG0002276	1	2	1	2	1	1	8
OG0002277	1	2	1	2	1	1	8
OG0002278	1	1	1	1	2	2	8
OG0002279	1	1	1	2	1	2	8
OG0002280	1	1	1	1	3	1	8
OG0002281	1	3	0	1	1	2	8
OG0002282	1	1	1	2	3	0	8
OG0002283	1	0	2	1	2	2	8
OG0002284	1	0	1	3	2	1	8
OG0002285	0	5	1	2	0	0	8
OG0002286	0	2	1	1	2	2	8
OG0002287	0	2	1	2	2	1	8
OG0002288	0	2	1	1	2	2	8
OG0002289	0	2	0	2	2	2	8
OG0002290	0	2	1	2	2	1	8
OG0002291	0	2	1	2	2	1	8
OG0002292	0	1	1	2	1	3	8
OG0002293	0	1	1	2	2	2	8
OG0002294	0	3	1	1	1	2	8
OG0002295	0	3	2	1	1	1	8
OG0002296	0	1	1	3	2	1	8
OG0002297	0	1	1	2	2	2	8
OG0002298	0	5	1	1	0	1	8
OG0002299	0	4	1	0	1	2	8
OG0002300	0	2	1	2	1	2	8
OG0002301	0	2	1	1	2	2	8
OG0002302	0	3	1	0	3	1	8
OG0002303	0	2	1	1	2	2	8
OG0002304	0	4	1	0	2	1	8
OG0002305	0	4	1	1	1	1	8
OG0002306	0	3	1	1	1	2	8
OG0002307	0	2	1	2	2	1	8
OG0002308	0	2	1	2	1	2	8
OG0002309	0	3	1	2	0	2	8
OG0002310	0	2	1	2	1	2	8
OG0002311	0	5	0	1	1	1	8
OG0002312	0	4	1	3	0	0	8
OG0002313	0	1	2	1	2	2	8
OG0002314	0	1	1	4	1	1	8
OG0002315	0	2	1	2	1	2	8
OG0002316	0	2	2	1	2	1	8
OG0002317	0	2	0	4	1	1	8
OG0002318	0	2	1	2	3	0	8
OG0002319	0	2	1	2	1	2	8
OG0002320	0	1	1	2	2	2	8
OG0002321	0	4	1	1	0	2	8
OG0002322	0	1	1	3	2	1	8
OG0002323	0	4	1	1	2	0	8
OG0002324	0	2	1	2	1	2	8
OG0002325	0	4	1	0	1	2	8
OG0002326	0	2	1	2	1	2	8
OG0002327	0	2	1	1	1	3	8
OG0002328	0	4	0	1	1	2	8
OG0002329	0	2	1	1	2	2	8
OG0002330	0	2	1	3	1	1	8
OG0002331	0	3	1	0	2	2	8
OG0002332	0	4	1	1	1	1	8
OG0002333	0	1	1	2	2	2	8
OG0002334	0	1	1	2	2	2	8
OG0002335	0	3	1	2	1	1	8
OG0002336	0	1	1	3	1	2	8
OG0002337	0	2	1	1	2	2	8
OG0002338	0	1	1	2	2	2	8
OG0002339	0	4	1	2	0	1	8
OG0002340	0	3	0	0	2	3	8
OG0002341	0	2	1	2	2	1	8
OG0002342	0	4	1	1	0	2	8
OG0002343	0	4	1	1	1	1	8
OG0002344	0	2	1	1	2	2	8
OG0002345	0	1	2	1	2	2	8
OG0002346	0	2	1	0	1	4	8
OG0002347	0	4	1	0	1	2	8
OG0002348	0	3	2	1	1	1	8
OG0002349	0	2	1	0	3	2	8
OG0002350	0	4	1	1	1	1	8
OG0002351	0	3	1	1	2	1	8
OG0002352	0	2	1	2	1	2	8
OG0002353	0	3	0	1	2	2	8
OG0002354	0	1	1	2	0	4	8
OG0002355	0	5	1	0	1	1	8
OG0002356	0	3	1	1	2	1	8
OG0002357	0	1	1	2	2	2	8
OG0002358	0	2	1	2	2	1	8
OG0002359	0	1	2	2	1	2	8
OG0002360	0	2	1	1	2	2	8
OG0002361	0	5	0	0	2	1	8
OG0002362	0	4	1	3	0	0	8
OG0002363	0	0	8	0	0	0	8
OG0002364	0	0	1	2	1	4	8
OG0002365	0	0	1	1	3	3	8
OG0002366	0	0	1	1	4	2	8
OG0002367	0	0	0	8	0	0	8
OG0002368	0	0	0	0	4	4	8
OG0002369	0	0	0	0	7	1	8
OG0002370	1	1	1	1	2	1	7
OG0002371	1	2	1	1	1	1	7
OG0002372	1	0	2	2	1	1	7
OG0002373	1	0	1	2	2	1	7
OG0002374	2	5	0	0	0	0	7
OG0002375	1	3	1	0	1	1	7
OG0002376	1	1	1	1	0	3	7
OG0002377	3	1	1	1	0	1	7
OG0002378	1	2	1	1	1	1	7
OG0002379	2	1	1	1	1	1	7
OG0002380	2	1	2	1	1	0	7
OG0002381	2	2	1	1	0	1	7
OG0002382	2	0	1	1	1	2	7
OG0002383	2	1	1	1	1	1	7
OG0002384	2	0	1	2	1	1	7
OG0002385	3	0	1	1	1	1	7
OG0002386	2	0	1	2	1	1	7
OG0002387	1	1	2	1	1	1	7
OG0002388	4	0	1	0	1	1	7
OG0002389	1	3	1	1	0	1	7
OG0002390	1	2	1	1	1	1	7
OG0002391	1	2	1	1	1	1	7
OG0002392	1	2	1	1	1	1	7
OG0002393	2	2	0	1	1	1	7
OG0002394	2	1	1	1	1	1	7
OG0002395	7	0	0	0	0	0	7
OG0002396	1	1	1	2	1	1	7
OG0002397	1	2	1	1	1	1	7
OG0002398	1	2	1	1	2	0	7
OG0002399	2	1	1	1	1	1	7
OG0002400	1	1	1	1	2	1	7
OG0002401	1	1	1	2	1	1	7
OG0002402	2	1	1	1	1	1	7
OG0002403	1	1	1	1	1	2	7
OG0002404	1	2	0	1	2	1	7
OG0002405	2	1	2	1	1	0	7
OG0002406	1	2	1	2	1	0	7
OG0002407	7	0	0	0	0	0	7
OG0002408	2	1	1	1	1	1	7
OG0002409	2	0	2	1	1	1	7
OG0002410	1	1	1	1	2	1	7
OG0002411	2	1	1	1	1	1	7
OG0002412	2	1	1	1	1	1	7
OG0002413	1	1	1	2	1	1	7
OG0002414	2	2	0	3	0	0	7
OG0002415	1	1	1	1	1	2	7
OG0002416	1	1	1	0	2	2	7
OG0002417	1	1	1	1	1	2	7
OG0002418	2	1	1	1	1	1	7
OG0002419	2	1	1	0	2	1	7
OG0002420	1	2	1	1	1	1	7
OG0002421	1	0	1	1	2	2	7
OG0002422	1	2	1	1	1	1	7
OG0002423	1	3	1	1	1	0	7
OG0002424	1	1	1	1	1	2	7
OG0002425	1	2	1	1	1	1	7
OG0002426	2	1	2	1	1	0	7
OG0002427	1	1	1	2	1	1	7
OG0002428	4	0	2	0	1	0	7
OG0002429	1	4	1	0	1	0	7
OG0002430	1	2	1	1	1	1	7
OG0002431	1	1	1	1	2	1	7
OG0002432	2	1	1	1	1	1	7
OG0002433	1	0	2	2	1	1	7
OG0002434	1	1	0	1	3	1	7
OG0002435	1	2	1	1	1	1	7
OG0002436	1	1	1	1	2	1	7
OG0002437	2	1	1	1	1	1	7
OG0002438	1	0	6	0	0	0	7
OG0002439	1	2	1	1	1	1	7
OG0002440	1	1	1	2	1	1	7
OG0002441	1	0	1	2	3	0	7
OG0002442	1	0	1	3	1	1	7
OG0002443	1	0	1	0	4	1	7
OG0002444	1	2	1	1	1	1	7
OG0002445	1	2	1	2	1	0	7
OG0002446	1	1	1	1	2	1	7
OG0002447	1	3	1	1	0	1	7
OG0002448	2	2	2	1	0	0	7
OG0002449	2	0	1	2	1	1	7
OG0002450	2	1	1	1	1	1	7
OG0002451	2	1	1	1	0	2	7
OG0002452	2	1	1	1	1	1	7
OG0002453	2	1	1	1	1	1	7
OG0002454	1	1	1	1	3	0	7
OG0002455	1	2	1	1	1	1	7
OG0002456	1	2	0	1	2	1	7
OG0002457	1	1	2	0	1	2	7
OG0002458	2	1	1	1	1	1	7
OG0002459	2	0	2	1	1	1	7
OG0002460	1	1	1	3	0	1	7
OG0002461	1	1	1	2	1	1	7
OG0002462	1	1	1	1	1	2	7
OG0002463	2	1	1	1	1	1	7
OG0002464	1	1	1	1	1	2	7
OG0002465	1	2	1	1	1	1	7
OG0002466	1	1	1	1	1	2	7
OG0002467	1	1	1	1	1	2	7
OG0002468	1	1	1	1	2	1	7
OG0002469	1	1	1	1	1	2	7
OG0002470	1	1	1	1	2	1	7
OG0002471	1	1	1	1	2	1	7
OG0002472	1	1	1	1	2	1	7
OG0002473	1	2	1	1	1	1	7
OG0002474	2	1	1	1	0	2	7
OG0002475	1	0	1	1	3	1	7
OG0002476	1	1	1	1	2	1	7
OG0002477	2	1	2	0	1	1	7
OG0002478	2	1	1	1	1	1	7
OG0002479	1	1	2	1	1	1	7
OG0002480	1	1	1	1	2	1	7
OG0002481	1	1	1	1	2	1	7
OG0002482	1	2	1	1	1	1	7
OG0002483	1	0	1	1	1	3	7
OG0002484	1	0	1	1	2	2	7
OG0002485	1	1	1	1	1	2	7
OG0002486	2	0	1	1	2	1	7
OG0002487	1	2	1	1	1	1	7
OG0002488	1	3	1	0	1	1	7
OG0002489	1	1	1	1	1	2	7
OG0002490	2	1	1	1	1	1	7
OG0002491	1	2	1	2	0	1	7
OG0002492	1	1	1	1	2	1	7
OG0002493	1	2	1	1	1	1	7
OG0002494	1	0	1	1	2	2	7
OG0002495	1	1	1	1	1	2	7
OG0002496	2	1	1	0	2	1	7
OG0002497	1	1	1	1	2	1	7
OG0002498	1	4	1	0	0	1	7
OG0002499	1	1	1	0	2	2	7
OG0002500	1	1	1	2	1	1	7
OG0002501	1	1	1	1	1	2	7
OG0002502	1	1	1	1	1	2	7
OG0002503	1	1	1	1	2	1	7
OG0002504	1	1	1	2	1	1	7
OG0002505	1	1	1	2	1	1	7
OG0002506	2	1	1	1	1	1	7
OG0002507	1	1	1	2	1	1	7
OG0002508	2	1	0	1	1	2	7
OG0002509	1	1	1	2	0	2	7
OG0002510	1	1	1	1	2	1	7
OG0002511	1	1	2	1	1	1	7
OG0002512	2	1	1	1	1	1	7
OG0002513	2	1	1	2	1	0	7
OG0002514	1	1	1	1	1	2	7
OG0002515	1	3	1	0	2	0	7
OG0002516	1	2	1	1	1	1	7
OG0002517	1	1	1	2	1	1	7
OG0002518	7	0	0	0	0	0	7
OG0002519	2	0	2	1	1	1	7
OG0002520	2	1	1	1	1	1	7
OG0002521	3	2	0	2	0	0	7
OG0002522	7	0	0	0	0	0	7
OG0002523	1	2	1	1	1	1	7
OG0002524	1	2	0	1	2	1	7
OG0002525	1	1	1	1	1	2	7
OG0002526	1	2	1	1	0	2	7
OG0002527	1	1	1	2	1	1	7
OG0002528	2	0	1	2	1	1	7
OG0002529	2	1	1	1	1	1	7
OG0002530	1	1	1	1	1	2	7
OG0002531	2	1	1	1	1	1	7
OG0002532	4	1	0	0	1	1	7
OG0002533	1	2	0	2	1	1	7
OG0002534	2	0	0	2	3	0	7
OG0002535	2	1	1	1	1	1	7
OG0002536	1	1	1	0	2	2	7
OG0002537	1	2	1	2	1	0	7
OG0002538	2	0	1	0	2	2	7
OG0002539	1	0	1	2	2	1	7
OG0002540	1	0	2	1	2	1	7
OG0002541	1	1	1	2	0	2	7
OG0002542	3	0	1	2	0	1	7
OG0002543	1	1	1	2	1	1	7
OG0002544	1	3	1	1	0	1	7
OG0002545	1	2	1	1	1	1	7
OG0002546	1	2	1	1	1	1	7
OG0002547	2	3	1	1	0	0	7
OG0002548	1	0	1	2	1	2	7
OG0002549	3	0	1	1	2	0	7
OG0002550	3	1	1	0	1	1	7
OG0002551	1	0	1	2	2	1	7
OG0002552	1	3	1	0	1	1	7
OG0002553	2	1	1	2	1	0	7
OG0002554	2	1	1	1	1	1	7
OG0002555	1	1	1	2	1	1	7
OG0002556	3	0	1	1	1	1	7
OG0002557	2	2	1	2	0	0	7
OG0002558	1	0	1	4	0	1	7
OG0002559	1	0	3	1	1	1	7
OG0002560	1	1	1	1	2	1	7
OG0002561	3	0	1	1	1	1	7
OG0002562	1	1	1	1	1	2	7
OG0002563	1	0	1	2	1	2	7
OG0002564	1	0	1	2	2	1	7
OG0002565	2	1	4	0	0	0	7
OG0002566	2	1	1	2	1	0	7
OG0002567	1	1	1	1	1	2	7
OG0002568	4	0	0	2	1	0	7
OG0002569	1	1	1	1	2	1	7
OG0002570	2	1	1	1	1	1	7
OG0002571	1	2	1	1	1	1	7
OG0002572	2	1	1	0	1	2	7
OG0002573	1	1	1	2	1	1	7
OG0002574	2	1	1	1	1	1	7
OG0002575	1	1	1	1	1	2	7
OG0002576	1	1	1	1	2	1	7
OG0002577	1	2	0	4	0	0	7
OG0002578	1	1	1	1	1	2	7
OG0002579	1	1	1	2	1	1	7
OG0002580	1	2	1	3	0	0	7
OG0002581	1	2	1	1	1	1	7
OG0002582	1	1	2	1	1	1	7
OG0002583	1	0	1	3	1	1	7
OG0002584	2	0	1	1	1	2	7
OG0002585	1	2	1	1	1	1	7
OG0002586	2	1	1	1	1	1	7
OG0002587	1	1	1	2	1	1	7
OG0002588	1	1	1	2	2	0	7
OG0002589	1	1	1	1	2	1	7
OG0002590	2	1	1	1	1	1	7
OG0002591	1	1	2	2	1	0	7
OG0002592	1	1	1	1	1	2	7
OG0002593	1	1	1	1	2	1	7
OG0002594	1	1	1	1	1	2	7
OG0002595	1	0	1	2	1	2	7
OG0002596	1	4	1	1	0	0	7
OG0002597	2	1	1	1	1	1	7
OG0002598	2	0	1	1	2	1	7
OG0002599	2	2	1	1	1	0	7
OG0002600	2	1	1	1	1	1	7
OG0002601	3	0	1	1	1	1	7
OG0002602	1	4	1	0	1	0	7
OG0002603	1	1	1	1	1	2	7
OG0002604	1	1	1	1	1	2	7
OG0002605	1	2	1	1	1	1	7
OG0002606	1	1	1	2	1	1	7
OG0002607	2	1	1	1	1	1	7
OG0002608	2	1	1	1	1	1	7
OG0002609	1	1	1	1	2	1	7
OG0002610	1	1	1	1	1	2	7
OG0002611	2	1	1	1	1	1	7
OG0002612	3	1	1	1	1	0	7
OG0002613	2	1	1	1	1	1	7
OG0002614	1	0	1	3	1	1	7
OG0002615	3	1	0	1	1	1	7
OG0002616	2	1	2	0	1	1	7
OG0002617	1	1	1	1	0	3	7
OG0002618	1	0	1	2	1	2	7
OG0002619	1	0	1	3	1	1	7
OG0002620	1	0	2	1	2	1	7
OG0002621	1	1	2	1	2	0	7
OG0002622	1	2	1	1	1	1	7
OG0002623	1	1	2	1	1	1	7
OG0002624	1	1	1	2	1	1	7
OG0002625	1	1	1	2	1	1	7
OG0002626	1	0	1	1	3	1	7
OG0002627	1	1	1	1	2	1	7
OG0002628	1	1	1	1	1	2	7
OG0002629	1	1	1	2	1	1	7
OG0002630	1	1	1	2	1	1	7
OG0002631	1	2	1	1	1	1	7
OG0002632	1	1	0	0	2	3	7
OG0002633	1	1	1	2	1	1	7
OG0002634	1	1	1	2	1	1	7
OG0002635	2	0	2	0	1	2	7
OG0002636	1	0	1	1	2	2	7
OG0002637	1	1	1	1	2	1	7
OG0002638	1	1	0	2	1	2	7
OG0002639	1	2	1	1	1	1	7
OG0002640	1	1	1	1	1	2	7
OG0002641	1	1	1	2	1	1	7
OG0002642	2	1	1	0	2	1	7
OG0002643	1	2	1	2	1	0	7
OG0002644	1	1	1	2	1	1	7
OG0002645	1	2	1	1	1	1	7
OG0002646	3	0	1	2	1	0	7
OG0002647	1	1	1	2	1	1	7
OG0002648	1	2	1	1	1	1	7
OG0002649	2	2	1	2	0	0	7
OG0002650	2	1	1	1	1	1	7
OG0002651	2	0	1	3	1	0	7
OG0002652	1	1	1	1	2	1	7
OG0002653	2	1	2	1	0	1	7
OG0002654	2	1	1	1	1	1	7
OG0002655	1	2	1	0	2	1	7
OG0002656	2	1	0	1	1	2	7
OG0002657	1	1	1	2	1	1	7
OG0002658	3	1	2	1	0	0	7
OG0002659	1	1	1	2	1	1	7
OG0002660	1	1	1	1	0	3	7
OG0002661	2	1	0	1	2	1	7
OG0002662	3	1	1	0	2	0	7
OG0002663	1	1	1	1	0	3	7
OG0002664	1	2	1	1	1	1	7
OG0002665	2	1	1	1	1	1	7
OG0002666	2	0	2	1	2	0	7
OG0002667	1	2	1	0	2	1	7
OG0002668	1	1	1	0	3	1	7
OG0002669	1	1	1	1	2	1	7
OG0002670	2	1	1	1	2	0	7
OG0002671	1	1	1	1	1	2	7
OG0002672	1	2	1	1	1	1	7
OG0002673	1	1	2	0	1	2	7
OG0002674	1	1	1	1	2	1	7
OG0002675	1	1	2	1	1	1	7
OG0002676	1	0	1	1	2	2	7
OG0002677	2	1	1	1	1	1	7
OG0002678	1	1	1	2	1	1	7
OG0002679	1	1	1	1	1	2	7
OG0002680	1	0	2	2	1	1	7
OG0002681	2	1	1	1	1	1	7
OG0002682	2	1	1	1	1	1	7
OG0002683	2	1	2	0	2	0	7
OG0002684	1	1	2	1	1	1	7
OG0002685	2	1	1	1	1	1	7
OG0002686	3	1	1	1	1	0	7
OG0002687	1	1	1	2	1	1	7
OG0002688	3	1	1	1	1	0	7
OG0002689	1	0	2	1	3	0	7
OG0002690	1	2	1	0	2	1	7
OG0002691	1	0	1	2	2	1	7
OG0002692	1	1	1	1	1	2	7
OG0002693	2	1	1	0	2	1	7
OG0002694	2	2	1	0	1	1	7
OG0002695	2	1	1	0	2	1	7
OG0002696	2	0	1	2	1	1	7
OG0002697	1	1	1	1	2	1	7
OG0002698	1	1	1	2	1	1	7
OG0002699	1	2	1	2	0	1	7
OG0002700	1	1	1	1	1	2	7
OG0002701	1	0	1	2	2	1	7
OG0002702	1	1	1	2	1	1	7
OG0002703	1	2	1	1	1	1	7
OG0002704	1	2	1	1	1	1	7
OG0002705	2	1	1	1	1	1	7
OG0002706	3	1	1	2	0	0	7
OG0002707	1	0	1	3	1	1	7
OG0002708	3	1	1	0	1	1	7
OG0002709	1	0	1	0	2	3	7
OG0002710	1	0	1	2	1	2	7
OG0002711	2	0	2	1	1	1	7
OG0002712	1	1	1	1	2	1	7
OG0002713	3	1	1	1	1	0	7
OG0002714	1	1	1	1	1	2	7
OG0002715	1	3	0	2	1	0	7
OG0002716	1	1	1	1	1	2	7
OG0002717	1	1	1	2	1	1	7
OG0002718	1	2	1	1	0	2	7
OG0002719	1	3	1	0	1	1	7
OG0002720	1	2	1	1	0	2	7
OG0002721	1	1	1	1	2	1	7
OG0002722	1	2	0	2	1	1	7
OG0002723	2	1	1	1	1	1	7
OG0002724	1	1	1	1	1	2	7
OG0002725	1	0	1	1	2	2	7
OG0002726	1	1	1	4	0	0	7
OG0002727	1	2	1	2	0	1	7
OG0002728	1	2	1	1	1	1	7
OG0002729	1	2	1	1	1	1	7
OG0002730	3	0	1	1	1	1	7
OG0002731	2	1	1	0	1	2	7
OG0002732	2	0	1	2	2	0	7
OG0002733	1	2	1	1	1	1	7
OG0002734	1	2	1	1	1	1	7
OG0002735	1	1	2	1	1	1	7
OG0002736	2	2	1	0	1	1	7
OG0002737	1	1	1	1	2	1	7
OG0002738	2	2	1	1	1	0	7
OG0002739	1	1	2	1	2	0	7
OG0002740	3	1	1	1	0	1	7
OG0002741	1	1	1	1	2	1	7
OG0002742	1	2	1	1	1	1	7
OG0002743	1	1	1	2	1	1	7
OG0002744	1	1	1	2	1	1	7
OG0002745	1	1	1	2	1	1	7
OG0002746	2	1	1	1	1	1	7
OG0002747	1	2	1	1	1	1	7
OG0002748	1	1	1	1	2	1	7
OG0002749	2	1	2	0	0	2	7
OG0002750	1	1	1	2	1	1	7
OG0002751	1	1	1	1	2	1	7
OG0002752	1	1	1	1	1	2	7
OG0002753	1	2	1	1	1	1	7
OG0002754	1	4	1	0	0	1	7
OG0002755	2	2	1	2	0	0	7
OG0002756	1	2	1	2	0	1	7
OG0002757	4	1	1	0	0	1	7
OG0002758	1	0	1	2	1	2	7
OG0002759	1	1	1	2	1	1	7
OG0002760	2	1	1	1	1	1	7
OG0002761	1	1	1	2	1	1	7
OG0002762	1	3	1	2	0	0	7
OG0002763	1	2	1	1	1	1	7
OG0002764	2	0	1	2	1	1	7
OG0002765	1	1	1	1	2	1	7
OG0002766	2	0	2	1	1	1	7
OG0002767	1	1	0	1	2	2	7
OG0002768	1	1	1	1	2	1	7
OG0002769	1	0	1	5	0	0	7
OG0002770	2	0	1	1	3	0	7
OG0002771	1	0	1	1	0	4	7
OG0002772	1	1	1	2	1	1	7
OG0002773	1	2	1	1	1	1	7
OG0002774	1	1	0	2	1	2	7
OG0002775	1	6	0	0	0	0	7
OG0002776	2	1	2	2	0	0	7
OG0002777	1	1	1	1	1	2	7
OG0002778	1	1	1	1	1	2	7
OG0002779	1	1	1	0	1	3	7
OG0002780	1	1	2	2	0	1	7
OG0002781	5	0	1	0	0	1	7
OG0002782	1	1	1	2	1	1	7
OG0002783	2	1	0	2	1	1	7
OG0002784	2	1	1	1	1	1	7
OG0002785	1	3	0	1	1	1	7
OG0002786	2	1	1	2	0	1	7
OG0002787	1	0	1	1	1	3	7
OG0002788	2	1	1	1	1	1	7
OG0002789	1	0	1	2	1	2	7
OG0002790	5	0	0	1	0	1	7
OG0002791	1	2	1	1	1	1	7
OG0002792	1	1	1	2	1	1	7
OG0002793	1	1	1	2	1	1	7
OG0002794	1	2	1	1	1	1	7
OG0002795	1	2	1	1	1	1	7
OG0002796	1	0	3	0	2	1	7
OG0002797	2	2	1	1	1	0	7
OG0002798	2	1	1	1	1	1	7
OG0002799	1	1	1	1	1	2	7
OG0002800	1	0	1	3	2	0	7
OG0002801	1	2	1	1	1	1	7
OG0002802	1	2	2	1	0	1	7
OG0002803	1	2	1	1	1	1	7
OG0002804	2	1	1	1	1	1	7
OG0002805	1	1	1	2	1	1	7
OG0002806	1	1	2	2	1	0	7
OG0002807	1	2	0	1	2	1	7
OG0002808	2	1	1	1	1	1	7
OG0002809	1	2	1	1	1	1	7
OG0002810	2	1	1	1	1	1	7
OG0002811	1	2	1	1	1	1	7
OG0002812	1	2	1	0	2	1	7
OG0002813	2	1	1	1	1	1	7
OG0002814	2	1	1	2	0	1	7
OG0002815	1	2	2	0	1	1	7
OG0002816	1	1	1	1	1	2	7
OG0002817	1	0	1	3	1	1	7
OG0002818	2	1	1	1	1	1	7
OG0002819	1	2	1	2	0	1	7
OG0002820	1	3	1	0	1	1	7
OG0002821	1	1	1	0	3	1	7
OG0002822	1	2	1	1	1	1	7
OG0002823	2	1	1	1	1	1	7
OG0002824	2	1	1	3	0	0	7
OG0002825	1	1	1	2	2	0	7
OG0002826	1	0	2	1	1	2	7
OG0002827	1	2	1	2	1	0	7
OG0002828	1	2	1	1	1	1	7
OG0002829	1	1	1	2	1	1	7
OG0002830	1	3	1	1	1	0	7
OG0002831	1	1	1	1	1	2	7
OG0002832	1	2	1	1	1	1	7
OG0002833	1	2	1	1	1	1	7
OG0002834	1	1	1	2	1	1	7
OG0002835	1	2	1	1	1	1	7
OG0002836	1	1	1	1	2	1	7
OG0002837	1	1	1	1	1	2	7
OG0002838	1	1	1	1	2	1	7
OG0002839	1	2	1	1	1	1	7
OG0002840	1	0	1	3	1	1	7
OG0002841	1	1	1	2	1	1	7
OG0002842	1	1	1	2	1	1	7
OG0002843	1	1	1	2	1	1	7
OG0002844	1	2	1	0	1	2	7
OG0002845	1	0	1	2	2	1	7
OG0002846	1	1	1	1	2	1	7
OG0002847	1	1	1	1	1	2	7
OG0002848	1	1	2	1	1	1	7
OG0002849	1	2	1	1	1	1	7
OG0002850	1	3	1	1	0	1	7
OG0002851	2	1	1	1	1	1	7
OG0002852	2	0	1	1	0	3	7
OG0002853	2	0	2	0	1	2	7
OG0002854	1	2	1	1	1	1	7
OG0002855	1	2	0	2	1	1	7
OG0002856	2	1	1	1	1	1	7
OG0002857	1	1	0	2	2	1	7
OG0002858	1	1	1	1	1	2	7
OG0002859	1	1	1	1	1	2	7
OG0002860	1	0	1	1	1	3	7
OG0002861	1	1	1	0	2	2	7
OG0002862	1	2	1	0	1	2	7
OG0002863	1	2	1	1	1	1	7
OG0002864	1	1	1	2	1	1	7
OG0002865	1	1	1	1	2	1	7
OG0002866	2	2	1	0	1	1	7
OG0002867	1	1	1	2	1	1	7
OG0002868	1	1	1	1	2	1	7
OG0002869	1	2	1	0	1	2	7
OG0002870	1	1	0	4	1	0	7
OG0002871	1	0	1	2	1	2	7
OG0002872	1	2	1	1	1	1	7
OG0002873	2	0	1	1	1	2	7
OG0002874	1	2	1	1	1	1	7
OG0002875	1	2	1	1	1	1	7
OG0002876	1	1	1	2	1	1	7
OG0002877	1	3	1	0	1	1	7
OG0002878	1	2	1	1	1	1	7
OG0002879	1	1	1	2	1	1	7
OG0002880	1	1	1	1	2	1	7
OG0002881	1	2	0	2	1	1	7
OG0002882	1	0	1	1	2	2	7
OG0002883	1	0	1	0	3	2	7
OG0002884	1	3	1	1	0	1	7
OG0002885	1	1	1	0	1	3	7
OG0002886	1	4	0	1	0	1	7
OG0002887	1	1	1	1	2	1	7
OG0002888	2	1	1	1	1	1	7
OG0002889	1	1	1	0	1	3	7
OG0002890	2	3	0	0	1	1	7
OG0002891	2	2	2	0	1	0	7
OG0002892	1	1	1	2	1	1	7
OG0002893	1	0	2	2	1	1	7
OG0002894	1	1	1	2	0	2	7
OG0002895	1	0	1	2	1	2	7
OG0002896	1	1	1	1	1	2	7
OG0002897	1	1	1	1	1	2	7
OG0002898	1	1	1	1	1	2	7
OG0002899	1	1	1	2	1	1	7
OG0002900	1	0	1	2	1	2	7
OG0002901	1	1	1	1	1	2	7
OG0002902	1	2	0	1	2	1	7
OG0002903	1	2	1	1	1	1	7
OG0002904	1	3	1	0	1	1	7
OG0002905	1	2	1	0	1	2	7
OG0002906	2	0	1	3	1	0	7
OG0002907	1	1	1	2	1	1	7
OG0002908	1	3	1	1	0	1	7
OG0002909	1	1	1	1	1	2	7
OG0002910	1	1	1	1	2	1	7
OG0002911	2	0	2	1	1	1	7
OG0002912	1	1	1	1	2	1	7
OG0002913	1	0	1	2	2	1	7
OG0002914	1	2	1	1	1	1	7
OG0002915	1	2	1	1	0	2	7
OG0002916	1	2	1	1	1	1	7
OG0002917	3	0	1	1	1	1	7
OG0002918	1	1	1	2	1	1	7
OG0002919	1	0	1	0	2	3	7
OG0002920	1	1	1	1	2	1	7
OG0002921	1	2	1	1	1	1	7
OG0002922	1	2	1	0	1	2	7
OG0002923	1	2	1	2	1	0	7
OG0002924	2	0	0	0	2	3	7
OG0002925	1	1	1	2	1	1	7
OG0002926	1	1	1	1	1	2	7
OG0002927	1	1	2	1	1	1	7
OG0002928	2	1	2	0	1	1	7
OG0002929	1	0	1	2	2	1	7
OG0002930	2	1	1	1	1	1	7
OG0002931	1	2	1	1	2	0	7
OG0002932	1	1	2	1	1	1	7
OG0002933	1	1	1	2	1	1	7
OG0002934	1	3	1	1	0	1	7
OG0002935	1	1	1	0	3	1	7
OG0002936	1	1	1	2	2	0	7
OG0002937	1	1	1	2	1	1	7
OG0002938	2	0	0	1	2	2	7
OG0002939	1	1	1	2	1	1	7
OG0002940	1	1	1	1	0	3	7
OG0002941	1	0	1	2	2	1	7
OG0002942	1	1	1	3	1	0	7
OG0002943	1	2	1	1	1	1	7
OG0002944	1	1	1	1	1	2	7
OG0002945	1	1	1	2	1	1	7
OG0002946	1	2	1	1	1	1	7
OG0002947	1	0	1	2	2	1	7
OG0002948	1	1	1	1	1	2	7
OG0002949	1	1	1	1	2	1	7
OG0002950	1	1	1	2	1	1	7
OG0002951	1	1	1	2	1	1	7
OG0002952	1	1	2	1	1	1	7
OG0002953	1	0	1	1	2	2	7
OG0002954	1	1	1	0	3	1	7
OG0002955	1	2	1	1	1	1	7
OG0002956	1	2	1	1	1	1	7
OG0002957	2	1	1	1	1	1	7
OG0002958	1	0	1	2	1	2	7
OG0002959	1	1	1	1	1	2	7
OG0002960	1	1	1	2	1	1	7
OG0002961	1	1	1	1	1	2	7
OG0002962	1	1	1	1	1	2	7
OG0002963	1	1	1	1	1	2	7
OG0002964	1	1	1	1	1	2	7
OG0002965	1	2	1	1	1	1	7
OG0002966	1	1	1	1	1	2	7
OG0002967	1	1	1	1	2	1	7
OG0002968	2	1	1	1	1	1	7
OG0002969	1	1	1	2	1	1	7
OG0002970	1	1	1	1	2	1	7
OG0002971	1	1	2	1	1	1	7
OG0002972	1	1	1	2	1	1	7
OG0002973	1	2	1	1	1	1	7
OG0002974	1	0	1	0	3	2	7
OG0002975	1	0	2	2	1	1	7
OG0002976	1	0	1	2	2	1	7
OG0002977	2	1	1	1	1	1	7
OG0002978	1	0	1	1	1	3	7
OG0002979	3	1	1	0	2	0	7
OG0002980	1	0	2	2	1	1	7
OG0002981	1	1	1	1	1	2	7
OG0002982	1	1	1	1	1	2	7
OG0002983	1	0	1	2	1	2	7
OG0002984	1	1	1	2	1	1	7
OG0002985	1	2	1	1	1	1	7
OG0002986	2	1	1	1	1	1	7
OG0002987	1	1	1	1	2	1	7
OG0002988	1	2	1	1	1	1	7
OG0002989	1	1	1	1	2	1	7
OG0002990	1	1	1	1	1	2	7
OG0002991	1	1	1	1	2	1	7
OG0002992	1	1	1	3	1	0	7
OG0002993	2	0	4	1	0	0	7
OG0002994	1	1	2	1	1	1	7
OG0002995	2	1	1	1	1	1	7
OG0002996	1	2	1	1	1	1	7
OG0002997	1	0	1	2	2	1	7
OG0002998	1	0	2	2	1	1	7
OG0002999	1	1	1	1	1	2	7
OG0003000	2	2	1	0	2	0	7
OG0003001	1	2	1	2	1	0	7
OG0003002	1	2	2	1	0	1	7
OG0003003	2	1	1	1	1	1	7
OG0003004	1	1	1	1	1	2	7
OG0003005	1	1	2	1	1	1	7
OG0003006	1	1	1	2	1	1	7
OG0003007	1	2	1	1	1	1	7
OG0003008	1	1	1	1	2	1	7
OG0003009	1	0	1	2	2	1	7
OG0003010	1	0	1	1	3	1	7
OG0003011	1	1	1	2	1	1	7
OG0003012	1	1	0	1	1	3	7
OG0003013	1	0	1	2	2	1	7
OG0003014	1	1	1	2	1	1	7
OG0003015	1	1	1	2	1	1	7
OG0003016	2	2	1	1	0	1	7
OG0003017	1	2	1	0	1	2	7
OG0003018	1	1	1	2	2	0	7
OG0003019	1	1	1	1	2	1	7
OG0003020	1	1	1	1	1	2	7
OG0003021	1	0	1	2	2	1	7
OG0003022	1	1	1	1	2	1	7
OG0003023	1	1	1	2	1	1	7
OG0003024	1	3	1	0	1	1	7
OG0003025	1	0	1	1	2	2	7
OG0003026	1	1	1	2	1	1	7
OG0003027	1	1	1	2	1	1	7
OG0003028	1	1	1	1	1	2	7
OG0003029	1	2	1	1	1	1	7
OG0003030	1	1	2	1	1	1	7
OG0003031	1	2	1	0	2	1	7
OG0003032	1	2	1	1	1	1	7
OG0003033	1	1	1	1	2	1	7
OG0003034	1	1	1	2	1	1	7
OG0003035	2	1	2	2	0	0	7
OG0003036	1	0	1	1	2	2	7
OG0003037	1	2	1	1	1	1	7
OG0003038	1	0	1	2	2	1	7
OG0003039	1	1	1	2	1	1	7
OG0003040	1	0	1	1	2	2	7
OG0003041	1	1	1	2	1	1	7
OG0003042	1	1	1	1	1	2	7
OG0003043	1	2	1	1	1	1	7
OG0003044	1	2	1	0	1	2	7
OG0003045	1	1	2	1	1	1	7
OG0003046	1	0	1	1	3	1	7
OG0003047	1	0	1	1	1	3	7
OG0003048	1	1	0	2	2	1	7
OG0003049	2	2	1	0	1	1	7
OG0003050	1	1	1	1	1	2	7
OG0003051	1	1	1	1	3	0	7
OG0003052	1	1	1	1	2	1	7
OG0003053	1	2	1	1	1	1	7
OG0003054	1	3	1	1	1	0	7
OG0003055	2	0	1	1	1	2	7
OG0003056	1	2	1	1	1	1	7
OG0003057	1	1	1	2	1	1	7
OG0003058	1	2	1	1	1	1	7
OG0003059	1	2	1	1	1	1	7
OG0003060	1	1	1	1	1	2	7
OG0003061	1	1	1	1	1	2	7
OG0003062	1	1	1	3	0	1	7
OG0003063	1	1	1	1	2	1	7
OG0003064	1	1	1	2	1	1	7
OG0003065	1	1	1	1	1	2	7
OG0003066	2	1	1	1	1	1	7
OG0003067	2	0	2	1	1	1	7
OG0003068	1	1	1	2	1	1	7
OG0003069	1	4	1	1	0	0	7
OG0003070	1	4	0	1	0	1	7
OG0003071	1	2	1	1	1	1	7
OG0003072	1	2	1	1	1	1	7
OG0003073	1	1	1	1	1	2	7
OG0003074	1	0	1	2	2	1	7
OG0003075	1	2	1	1	1	1	7
OG0003076	1	2	1	1	1	1	7
OG0003077	1	1	0	4	1	0	7
OG0003078	1	1	1	1	2	1	7
OG0003079	1	1	1	1	1	2	7
OG0003080	1	2	1	0	2	1	7
OG0003081	1	2	1	1	1	1	7
OG0003082	1	2	1	1	1	1	7
OG0003083	1	2	1	1	1	1	7
OG0003084	1	1	1	1	2	1	7
OG0003085	1	2	1	1	1	1	7
OG0003086	1	1	1	2	2	0	7
OG0003087	1	2	1	1	1	1	7
OG0003088	2	1	0	1	1	2	7
OG0003089	2	1	1	1	1	1	7
OG0003090	2	1	1	1	1	1	7
OG0003091	1	3	1	0	1	1	7
OG0003092	1	3	1	0	1	1	7
OG0003093	1	1	1	2	1	1	7
OG0003094	1	1	1	2	1	1	7
OG0003095	1	0	1	2	1	2	7
OG0003096	1	3	1	0	2	0	7
OG0003097	1	2	1	1	1	1	7
OG0003098	1	0	1	3	1	1	7
OG0003099	1	1	1	2	1	1	7
OG0003100	1	1	1	0	1	3	7
OG0003101	1	1	1	1	1	2	7
OG0003102	1	1	1	2	1	1	7
OG0003103	1	1	1	1	0	3	7
OG0003104	1	1	1	0	2	2	7
OG0003105	1	1	1	0	2	2	7
OG0003106	1	1	2	1	1	1	7
OG0003107	1	3	0	0	1	2	7
OG0003108	1	1	1	2	1	1	7
OG0003109	1	1	1	1	2	1	7
OG0003110	1	1	1	1	1	2	7
OG0003111	1	1	1	1	1	2	7
OG0003112	1	1	1	2	1	1	7
OG0003113	1	1	1	1	1	2	7
OG0003114	1	1	1	2	1	1	7
OG0003115	1	1	1	2	1	1	7
OG0003116	2	1	1	1	1	1	7
OG0003117	1	1	1	2	1	1	7
OG0003118	1	1	1	2	1	1	7
OG0003119	2	1	1	1	1	1	7
OG0003120	1	1	1	3	0	1	7
OG0003121	1	0	1	2	1	2	7
OG0003122	1	0	1	2	1	2	7
OG0003123	1	0	1	1	3	1	7
OG0003124	2	1	1	1	1	1	7
OG0003125	1	2	1	1	1	1	7
OG0003126	2	0	1	2	1	1	7
OG0003127	1	1	2	2	1	0	7
OG0003128	1	0	1	1	2	2	7
OG0003129	1	2	1	1	0	2	7
OG0003130	1	1	1	2	1	1	7
OG0003131	1	0	1	3	1	1	7
OG0003132	1	0	1	2	1	2	7
OG0003133	1	1	1	1	1	2	7
OG0003134	1	1	1	2	1	1	7
OG0003135	1	1	2	1	0	2	7
OG0003136	1	2	0	2	1	1	7
OG0003137	1	1	1	1	3	0	7
OG0003138	1	1	1	2	1	1	7
OG0003139	1	1	0	1	2	2	7
OG0003140	1	2	1	1	0	2	7
OG0003141	1	2	1	1	1	1	7
OG0003142	1	1	2	1	1	1	7
OG0003143	1	2	1	1	1	1	7
OG0003144	1	3	1	1	1	0	7
OG0003145	1	2	1	1	1	1	7
OG0003146	1	1	1	1	1	2	7
OG0003147	1	1	2	1	1	1	7
OG0003148	1	1	1	2	1	1	7
OG0003149	1	1	1	3	1	0	7
OG0003150	1	1	1	2	1	1	7
OG0003151	1	2	0	1	2	1	7
OG0003152	1	0	1	1	2	2	7
OG0003153	1	1	1	2	1	1	7
OG0003154	1	2	1	1	1	1	7
OG0003155	4	2	0	0	1	0	7
OG0003156	1	1	1	2	1	1	7
OG0003157	1	1	1	1	2	1	7
OG0003158	1	0	1	2	1	2	7
OG0003159	1	0	2	1	2	1	7
OG0003160	1	1	1	2	1	1	7
OG0003161	1	1	1	1	1	2	7
OG0003162	1	0	1	2	1	2	7
OG0003163	1	2	1	1	1	1	7
OG0003164	1	3	1	0	1	1	7
OG0003165	2	1	2	0	1	1	7
OG0003166	1	2	1	1	1	1	7
OG0003167	2	1	1	1	1	1	7
OG0003168	0	1	1	1	2	2	7
OG0003169	0	2	1	1	2	1	7
OG0003170	0	3	1	1	1	1	7
OG0003171	0	3	1	1	1	1	7
OG0003172	0	1	1	3	1	1	7
OG0003173	0	1	0	2	2	2	7
OG0003174	0	2	1	0	1	3	7
OG0003175	0	1	1	2	1	2	7
OG0003176	0	1	1	1	2	2	7
OG0003177	0	1	1	1	2	2	7
OG0003178	0	1	1	2	1	2	7
OG0003179	0	2	1	1	2	1	7
OG0003180	0	2	1	1	1	2	7
OG0003181	0	2	1	0	0	4	7
OG0003182	0	2	1	2	1	1	7
OG0003183	0	2	1	2	1	1	7
OG0003184	0	2	1	2	1	1	7
OG0003185	0	3	1	1	1	1	7
OG0003186	0	2	1	1	1	2	7
OG0003187	0	1	1	2	2	1	7
OG0003188	0	1	1	3	1	1	7
OG0003189	0	2	1	2	1	1	7
OG0003190	0	1	1	1	3	1	7
OG0003191	0	2	1	2	2	0	7
OG0003192	0	2	1	1	2	1	7
OG0003193	0	2	1	1	0	3	7
OG0003194	0	2	1	2	1	1	7
OG0003195	0	2	1	2	1	1	7
OG0003196	0	3	1	1	1	1	7
OG0003197	0	4	1	0	1	1	7
OG0003198	0	1	1	1	3	1	7
OG0003199	0	3	1	1	1	1	7
OG0003200	0	4	0	2	0	1	7
OG0003201	0	3	1	1	1	1	7
OG0003202	0	3	0	1	2	1	7
OG0003203	0	2	1	1	1	2	7
OG0003204	0	3	0	1	0	3	7
OG0003205	0	3	1	1	1	1	7
OG0003206	0	2	1	1	0	3	7
OG0003207	0	1	1	0	2	3	7
OG0003208	0	2	2	1	1	1	7
OG0003209	0	5	0	2	0	0	7
OG0003210	0	3	1	1	1	1	7
OG0003211	0	1	1	1	2	2	7
OG0003212	0	2	1	2	1	1	7
OG0003213	0	2	1	1	2	1	7
OG0003214	0	2	1	1	1	2	7
OG0003215	0	1	1	3	1	1	7
OG0003216	0	3	1	1	1	1	7
OG0003217	0	2	1	2	1	1	7
OG0003218	0	2	1	1	2	1	7
OG0003219	0	2	1	1	1	2	7
OG0003220	0	3	2	0	0	2	7
OG0003221	0	2	1	2	1	1	7
OG0003222	0	2	2	1	1	1	7
OG0003223	0	2	1	2	1	1	7
OG0003224	0	1	0	3	0	3	7
OG0003225	0	2	1	1	2	1	7
OG0003226	0	2	1	2	1	1	7
OG0003227	0	2	1	1	1	2	7
OG0003228	0	1	1	1	2	2	7
OG0003229	0	1	1	2	2	1	7
OG0003230	0	2	1	2	0	2	7
OG0003231	0	3	1	2	1	0	7
OG0003232	0	3	1	1	1	1	7
OG0003233	0	1	1	1	3	1	7
OG0003234	0	3	1	2	1	0	7
OG0003235	0	2	2	1	0	2	7
OG0003236	0	1	1	2	1	2	7
OG0003237	0	1	1	1	1	3	7
OG0003238	0	1	3	2	1	0	7
OG0003239	0	2	1	1	1	2	7
OG0003240	0	1	1	1	2	2	7
OG0003241	0	1	1	1	2	2	7
OG0003242	0	2	1	0	1	3	7
OG0003243	0	2	1	2	1	1	7
OG0003244	0	2	1	2	1	1	7
OG0003245	0	1	1	1	2	2	7
OG0003246	0	3	1	1	1	1	7
OG0003247	0	1	1	1	1	3	7
OG0003248	0	2	1	1	1	2	7
OG0003249	0	1	1	2	2	1	7
OG0003250	0	1	2	3	0	1	7
OG0003251	0	3	1	0	1	2	7
OG0003252	0	3	1	1	1	1	7
OG0003253	0	2	1	2	1	1	7
OG0003254	0	2	1	2	2	0	7
OG0003255	0	2	1	1	2	1	7
OG0003256	0	2	1	2	2	0	7
OG0003257	0	4	1	1	1	0	7
OG0003258	0	1	0	1	1	4	7
OG0003259	0	2	1	1	1	2	7
OG0003260	0	1	1	2	2	1	7
OG0003261	0	1	1	0	3	2	7
OG0003262	0	2	1	1	2	1	7
OG0003263	0	1	1	2	1	2	7
OG0003264	0	2	1	1	2	1	7
OG0003265	0	2	1	2	1	1	7
OG0003266	0	2	0	1	1	3	7
OG0003267	0	4	1	1	1	0	7
OG0003268	0	3	1	1	1	1	7
OG0003269	0	2	1	2	1	1	7
OG0003270	0	1	1	2	2	1	7
OG0003271	0	2	2	2	0	1	7
OG0003272	0	2	1	2	1	1	7
OG0003273	0	2	1	2	1	1	7
OG0003274	0	2	1	1	1	2	7
OG0003275	0	2	2	1	1	1	7
OG0003276	0	2	1	2	1	1	7
OG0003277	0	2	1	1	1	2	7
OG0003278	0	2	1	2	1	1	7
OG0003279	0	2	1	1	2	1	7
OG0003280	0	2	1	1	1	2	7
OG0003281	0	1	0	5	1	0	7
OG0003282	0	5	0	1	1	0	7
OG0003283	0	2	1	1	1	2	7
OG0003284	0	1	1	2	2	1	7
OG0003285	0	1	1	2	2	1	7
OG0003286	0	1	2	1	1	2	7
OG0003287	0	2	0	2	2	1	7
OG0003288	0	2	1	2	1	1	7
OG0003289	0	1	1	1	2	2	7
OG0003290	0	2	1	1	1	2	7
OG0003291	0	1	1	1	1	3	7
OG0003292	0	1	0	2	1	3	7
OG0003293	0	1	1	2	2	1	7
OG0003294	0	2	2	1	1	1	7
OG0003295	0	1	1	1	3	1	7
OG0003296	0	1	1	1	2	2	7
OG0003297	0	2	1	1	1	2	7
OG0003298	0	2	1	1	1	2	7
OG0003299	0	1	1	2	1	2	7
OG0003300	0	3	1	1	1	1	7
OG0003301	0	2	1	2	1	1	7
OG0003302	0	1	1	1	3	1	7
OG0003303	0	2	1	2	1	1	7
OG0003304	0	1	1	2	1	2	7
OG0003305	0	1	1	1	3	1	7
OG0003306	0	1	1	1	2	2	7
OG0003307	0	4	1	1	1	0	7
OG0003308	0	3	1	0	1	2	7
OG0003309	0	2	1	1	2	1	7
OG0003310	0	0	2	1	1	3	7
OG0003311	0	0	2	1	3	1	7
OG0003312	0	0	1	3	0	3	7
OG0003313	0	0	4	2	0	1	7
OG0003314	0	0	7	0	0	0	7
OG0003315	0	0	1	2	3	1	7
OG0003316	0	0	2	3	1	1	7
OG0003317	0	0	1	1	3	2	7
OG0003318	0	0	1	0	3	3	7
OG0003319	0	0	1	3	2	1	7
OG0003320	0	0	1	2	1	3	7
OG0003321	0	0	1	1	3	2	7
OG0003322	0	0	1	2	4	0	7
OG0003323	0	0	1	2	1	3	7
OG0003324	0	0	1	1	3	2	7
OG0003325	0	0	1	1	2	3	7
OG0003326	0	0	1	5	1	0	7
OG0003327	0	0	1	2	2	2	7
OG0003328	0	0	1	4	1	1	7
OG0003329	0	0	1	0	3	3	7
OG0003330	0	0	0	1	2	4	7
OG0003331	0	0	0	1	5	1	7
OG0003332	0	0	0	0	3	4	7
OG0003333	0	0	0	0	0	7	7
OG0003334	0	0	0	0	0	7	7
OG0003335	1	1	1	1	1	1	6
OG0003336	1	0	1	1	1	2	6
OG0003337	3	0	1	1	1	0	6
OG0003338	1	1	1	1	1	1	6
OG0003339	2	1	1	1	1	0	6
OG0003340	1	1	1	1	1	1	6
OG0003341	1	1	1	1	1	1	6
OG0003342	1	0	1	1	1	2	6
OG0003343	1	1	1	1	1	1	6
OG0003344	1	2	1	0	1	1	6
OG0003345	1	0	1	2	1	1	6
OG0003346	1	0	1	1	1	2	6
OG0003347	1	1	1	1	1	1	6
OG0003348	1	0	1	0	3	1	6
OG0003349	1	1	1	1	1	1	6
OG0003350	1	1	1	1	1	1	6
OG0003351	2	1	1	1	0	1	6
OG0003352	1	1	1	1	1	1	6
OG0003353	1	1	1	1	1	1	6
OG0003354	1	0	1	3	0	1	6
OG0003355	2	0	1	1	1	1	6
OG0003356	1	1	1	1	1	1	6
OG0003357	2	1	1	1	1	0	6
OG0003358	1	0	1	2	1	1	6
OG0003359	1	1	1	0	1	2	6
OG0003360	1	1	1	1	1	1	6
OG0003361	1	1	2	1	0	1	6
OG0003362	1	1	1	1	1	1	6
OG0003363	1	1	1	1	1	1	6
OG0003364	1	1	1	1	1	1	6
OG0003365	1	0	0	0	0	5	6
OG0003366	1	0	1	1	2	1	6
OG0003367	1	0	1	1	1	2	6
OG0003368	2	1	1	0	1	1	6
OG0003369	1	1	1	1	1	1	6
OG0003370	1	1	1	1	1	1	6
OG0003371	2	1	1	1	1	0	6
OG0003372	1	2	1	0	1	1	6
OG0003373	1	1	1	1	1	1	6
OG0003374	1	2	1	1	0	1	6
OG0003375	1	2	1	1	0	1	6
OG0003376	1	1	0	1	1	2	6
OG0003377	1	1	1	1	1	1	6
OG0003378	1	0	1	1	1	2	6
OG0003379	1	1	1	1	1	1	6
OG0003380	1	2	1	0	1	1	6
OG0003381	2	0	1	1	1	1	6
OG0003382	1	1	1	0	0	3	6
OG0003383	1	1	1	1	2	0	6
OG0003384	1	1	0	4	0	0	6
OG0003385	6	0	0	0	0	0	6
OG0003386	2	1	1	1	0	1	6
OG0003387	6	0	0	0	0	0	6
OG0003388	2	1	2	0	1	0	6
OG0003389	1	1	1	1	1	1	6
OG0003390	2	1	1	0	1	1	6
OG0003391	2	0	1	1	1	1	6
OG0003392	1	0	1	2	0	2	6
OG0003393	1	0	1	2	1	1	6
OG0003394	1	0	1	1	2	1	6
OG0003395	1	1	1	1	1	1	6
OG0003396	1	1	1	1	1	1	6
OG0003397	2	1	1	1	1	0	6
OG0003398	1	1	1	1	1	1	6
OG0003399	1	0	1	2	1	1	6
OG0003400	1	1	0	1	1	2	6
OG0003401	1	1	1	2	1	0	6
OG0003402	1	1	1	1	1	1	6
OG0003403	1	1	1	1	1	1	6
OG0003404	1	0	1	1	1	2	6
OG0003405	1	1	1	0	1	2	6
OG0003406	1	1	1	2	0	1	6
OG0003407	1	4	1	0	0	0	6
OG0003408	1	1	1	1	1	1	6
OG0003409	1	1	1	2	1	0	6
OG0003410	2	1	1	1	0	1	6
OG0003411	1	0	1	1	0	3	6
OG0003412	1	1	1	1	1	1	6
OG0003413	1	2	0	2	1	0	6
OG0003414	1	1	1	2	0	1	6
OG0003415	2	1	1	0	1	1	6
OG0003416	2	0	1	2	0	1	6
OG0003417	1	0	2	0	0	3	6
OG0003418	3	0	1	1	0	1	6
OG0003419	2	1	1	1	1	0	6
OG0003420	1	0	1	1	1	2	6
OG0003421	1	1	1	1	1	1	6
OG0003422	1	1	1	1	1	1	6
OG0003423	1	1	1	1	1	1	6
OG0003424	1	1	1	1	1	1	6
OG0003425	1	1	1	1	1	1	6
OG0003426	1	1	1	2	1	0	6
OG0003427	1	0	1	2	1	1	6
OG0003428	1	1	1	2	0	1	6
OG0003429	2	0	1	2	1	0	6
OG0003430	1	0	0	0	5	0	6
OG0003431	1	1	1	1	1	1	6
OG0003432	2	0	1	1	1	1	6
OG0003433	1	0	1	2	1	1	6
OG0003434	1	0	1	2	1	1	6
OG0003435	1	1	1	0	2	1	6
OG0003436	1	0	2	1	2	0	6
OG0003437	2	2	1	1	0	0	6
OG0003438	2	1	1	0	2	0	6
OG0003439	1	0	1	1	2	1	6
OG0003440	1	1	1	1	1	1	6
OG0003441	1	1	1	1	1	1	6
OG0003442	2	0	1	1	0	2	6
OG0003443	1	1	0	1	2	1	6
OG0003444	1	0	1	1	1	2	6
OG0003445	1	0	1	3	1	0	6
OG0003446	1	1	0	2	1	1	6
OG0003447	1	1	1	1	0	2	6
OG0003448	5	0	0	0	0	1	6
OG0003449	1	1	1	1	2	0	6
OG0003450	1	0	1	1	1	2	6
OG0003451	1	1	1	1	1	1	6
OG0003452	3	1	1	1	0	0	6
OG0003453	2	0	1	1	1	1	6
OG0003454	6	0	0	0	0	0	6
OG0003455	2	1	1	1	1	0	6
OG0003456	1	1	1	0	2	1	6
OG0003457	1	1	1	1	1	1	6
OG0003458	1	1	1	1	1	1	6
OG0003459	1	0	1	1	1	2	6
OG0003460	1	1	1	1	1	1	6
OG0003461	2	1	1	0	1	1	6
OG0003462	2	0	1	1	1	1	6
OG0003463	1	1	1	2	0	1	6
OG0003464	1	2	1	1	0	1	6
OG0003465	2	0	2	1	0	1	6
OG0003466	2	1	1	1	0	1	6
OG0003467	1	1	1	1	1	1	6
OG0003468	1	0	1	2	1	1	6
OG0003469	1	2	1	1	1	0	6
OG0003470	3	1	1	1	0	0	6
OG0003471	1	1	1	1	1	1	6
OG0003472	1	0	1	1	2	1	6
OG0003473	3	1	1	0	1	0	6
OG0003474	1	1	1	0	2	1	6
OG0003475	1	1	1	0	1	2	6
OG0003476	3	1	1	1	0	0	6
OG0003477	1	1	1	1	1	1	6
OG0003478	1	1	1	0	1	2	6
OG0003479	1	1	1	0	2	1	6
OG0003480	1	2	1	1	1	0	6
OG0003481	3	1	0	0	1	1	6
OG0003482	3	0	1	0	1	1	6
OG0003483	2	0	1	1	1	1	6
OG0003484	1	2	1	1	0	1	6
OG0003485	2	1	1	1	1	0	6
OG0003486	2	1	2	0	0	1	6
OG0003487	1	1	1	1	1	1	6
OG0003488	2	0	1	1	1	1	6
OG0003489	1	1	1	2	0	1	6
OG0003490	2	1	1	1	0	1	6
OG0003491	2	0	1	1	1	1	6
OG0003492	2	2	1	1	0	0	6
OG0003493	1	1	1	1	1	1	6
OG0003494	1	2	0	1	1	1	6
OG0003495	1	1	1	1	1	1	6
OG0003496	1	1	1	1	1	1	6
OG0003497	1	1	1	1	1	1	6
OG0003498	1	1	1	1	1	1	6
OG0003499	1	1	1	1	1	1	6
OG0003500	4	1	0	0	1	0	6
OG0003501	1	1	1	1	1	1	6
OG0003502	1	1	1	1	1	1	6
OG0003503	2	1	1	1	1	0	6
OG0003504	1	1	0	1	1	2	6
OG0003505	1	0	2	1	1	1	6
OG0003506	1	1	1	2	1	0	6
OG0003507	1	1	1	1	1	1	6
OG0003508	1	1	1	1	1	1	6
OG0003509	1	1	1	1	1	1	6
OG0003510	1	1	1	2	0	1	6
OG0003511	1	1	1	0	2	1	6
OG0003512	1	0	1	1	1	2	6
OG0003513	1	1	1	1	1	1	6
OG0003514	1	1	1	1	1	1	6
OG0003515	1	2	1	0	1	1	6
OG0003516	1	0	1	2	2	0	6
OG0003517	1	0	1	1	1	2	6
OG0003518	1	1	1	1	2	0	6
OG0003519	1	1	1	1	1	1	6
OG0003520	1	1	1	1	1	1	6
OG0003521	1	1	1	1	1	1	6
OG0003522	1	0	1	2	1	1	6
OG0003523	1	1	1	1	1	1	6
OG0003524	2	0	1	1	1	1	6
OG0003525	1	1	1	1	0	2	6
OG0003526	1	2	1	1	1	0	6
OG0003527	1	1	1	1	1	1	6
OG0003528	1	1	1	0	1	2	6
OG0003529	2	1	1	1	0	1	6
OG0003530	1	2	1	1	0	1	6
OG0003531	1	1	1	1	1	1	6
OG0003532	2	0	1	2	1	0	6
OG0003533	1	1	1	1	1	1	6
OG0003534	1	1	1	1	1	1	6
OG0003535	1	1	1	1	1	1	6
OG0003536	1	1	1	0	2	1	6
OG0003537	2	2	1	1	0	0	6
OG0003538	1	1	1	1	1	1	6
OG0003539	1	1	1	1	1	1	6
OG0003540	1	1	1	1	1	1	6
OG0003541	1	2	1	1	0	1	6
OG0003542	1	1	2	1	0	1	6
OG0003543	1	1	1	1	1	1	6
OG0003544	1	0	1	0	1	3	6
OG0003545	1	1	1	1	1	1	6
OG0003546	1	1	2	0	2	0	6
OG0003547	1	2	1	1	0	1	6
OG0003548	1	1	1	1	1	1	6
OG0003549	3	0	1	1	1	0	6
OG0003550	1	0	1	2	1	1	6
OG0003551	1	1	1	1	1	1	6
OG0003552	1	1	1	1	1	1	6
OG0003553	1	1	1	1	0	2	6
OG0003554	1	1	1	2	0	1	6
OG0003555	1	1	1	1	1	1	6
OG0003556	1	1	1	1	1	1	6
OG0003557	1	1	1	2	0	1	6
OG0003558	2	0	1	1	2	0	6
OG0003559	1	0	1	2	1	1	6
OG0003560	1	1	1	1	0	2	6
OG0003561	1	1	1	1	1	1	6
OG0003562	2	1	1	1	1	0	6
OG0003563	1	0	1	2	1	1	6
OG0003564	1	1	1	1	1	1	6
OG0003565	2	1	1	0	1	1	6
OG0003566	2	0	1	1	1	1	6
OG0003567	1	1	1	1	1	1	6
OG0003568	1	1	1	1	0	2	6
OG0003569	1	1	1	2	0	1	6
OG0003570	1	2	1	0	1	1	6
OG0003571	2	1	1	1	1	0	6
OG0003572	1	1	1	0	1	2	6
OG0003573	1	1	1	1	1	1	6
OG0003574	1	1	1	1	1	1	6
OG0003575	2	0	1	1	1	1	6
OG0003576	2	0	1	1	1	1	6
OG0003577	2	0	1	1	1	1	6
OG0003578	2	0	1	1	1	1	6
OG0003579	5	0	1	0	0	0	6
OG0003580	1	2	1	1	1	0	6
OG0003581	1	1	1	1	1	1	6
OG0003582	1	0	1	1	1	2	6
OG0003583	2	1	0	0	2	1	6
OG0003584	1	0	1	2	1	1	6
OG0003585	1	1	1	1	1	1	6
OG0003586	1	1	1	1	1	1	6
OG0003587	1	1	1	1	1	1	6
OG0003588	1	1	1	0	2	1	6
OG0003589	1	0	1	2	2	0	6
OG0003590	2	1	1	0	0	2	6
OG0003591	1	1	1	1	1	1	6
OG0003592	1	0	1	2	1	1	6
OG0003593	4	2	0	0	0	0	6
OG0003594	2	0	1	0	2	1	6
OG0003595	1	1	1	0	2	1	6
OG0003596	1	1	1	1	1	1	6
OG0003597	2	0	1	1	1	1	6
OG0003598	2	0	1	2	1	0	6
OG0003599	1	1	1	1	1	1	6
OG0003600	1	1	1	1	1	1	6
OG0003601	2	0	0	2	1	1	6
OG0003602	1	0	1	1	1	2	6
OG0003603	1	2	1	1	1	0	6
OG0003604	2	0	1	0	1	2	6
OG0003605	1	1	1	1	1	1	6
OG0003606	1	1	2	1	0	1	6
OG0003607	2	0	1	1	1	1	6
OG0003608	1	1	1	1	1	1	6
OG0003609	1	0	1	2	0	2	6
OG0003610	1	0	1	2	1	1	6
OG0003611	2	1	1	1	1	0	6
OG0003612	1	0	1	1	1	2	6
OG0003613	1	1	1	2	1	0	6
OG0003614	1	0	1	1	1	2	6
OG0003615	1	1	1	2	0	1	6
OG0003616	2	1	1	0	1	1	6
OG0003617	1	0	1	2	1	1	6
OG0003618	2	0	1	1	1	1	6
OG0003619	1	2	1	1	0	1	6
OG0003620	1	1	1	1	1	1	6
OG0003621	1	1	1	1	1	1	6
OG0003622	1	1	1	2	1	0	6
OG0003623	3	0	0	1	1	1	6
OG0003624	1	0	1	1	2	1	6
OG0003625	1	1	1	1	1	1	6
OG0003626	1	0	1	1	2	1	6
OG0003627	1	1	1	2	1	0	6
OG0003628	1	1	1	1	1	1	6
OG0003629	1	1	1	1	1	1	6
OG0003630	1	1	1	1	1	1	6
OG0003631	1	2	1	0	1	1	6
OG0003632	1	1	1	1	1	1	6
OG0003633	1	1	1	2	1	0	6
OG0003634	2	0	1	1	2	0	6
OG0003635	3	2	1	0	0	0	6
OG0003636	2	1	1	1	1	0	6
OG0003637	1	1	1	0	2	1	6
OG0003638	1	1	1	1	1	1	6
OG0003639	2	1	1	1	0	1	6
OG0003640	1	1	1	1	1	1	6
OG0003641	1	0	2	0	1	2	6
OG0003642	1	2	1	1	0	1	6
OG0003643	2	2	1	0	1	0	6
OG0003644	1	1	1	1	1	1	6
OG0003645	1	1	1	1	1	1	6
OG0003646	1	1	1	1	1	1	6
OG0003647	1	0	1	1	1	2	6
OG0003648	1	2	1	1	0	1	6
OG0003649	1	1	1	1	1	1	6
OG0003650	2	0	1	1	1	1	6
OG0003651	1	1	1	1	1	1	6
OG0003652	1	1	1	1	1	1	6
OG0003653	1	0	1	2	1	1	6
OG0003654	2	0	1	2	0	1	6
OG0003655	1	1	1	1	1	1	6
OG0003656	1	1	1	1	1	1	6
OG0003657	1	0	1	1	1	2	6
OG0003658	1	1	1	1	1	1	6
OG0003659	1	1	1	1	1	1	6
OG0003660	1	1	1	1	1	1	6
OG0003661	1	0	1	1	2	1	6
OG0003662	1	2	1	1	0	1	6
OG0003663	1	0	1	3	0	1	6
OG0003664	1	0	2	1	1	1	6
OG0003665	1	1	1	1	1	1	6
OG0003666	1	1	1	2	1	0	6
OG0003667	1	3	1	0	1	0	6
OG0003668	1	0	1	1	2	1	6
OG0003669	1	1	1	1	1	1	6
OG0003670	2	0	1	2	0	1	6
OG0003671	2	0	1	1	1	1	6
OG0003672	1	1	1	1	1	1	6
OG0003673	1	0	1	2	1	1	6
OG0003674	2	0	1	2	0	1	6
OG0003675	1	0	1	1	2	1	6
OG0003676	1	1	1	1	0	2	6
OG0003677	2	1	1	0	0	2	6
OG0003678	1	2	1	1	1	0	6
OG0003679	1	1	1	1	1	1	6
OG0003680	1	0	1	1	2	1	6
OG0003681	1	1	1	0	2	1	6
OG0003682	1	2	1	1	0	1	6
OG0003683	1	1	1	2	1	0	6
OG0003684	1	2	1	1	0	1	6
OG0003685	1	1	1	1	1	1	6
OG0003686	1	0	1	2	1	1	6
OG0003687	1	1	1	1	1	1	6
OG0003688	1	3	1	1	0	0	6
OG0003689	2	1	1	0	2	0	6
OG0003690	1	1	1	0	3	0	6
OG0003691	1	1	0	1	1	2	6
OG0003692	1	1	1	1	1	1	6
OG0003693	1	1	1	1	1	1	6
OG0003694	1	2	1	1	1	0	6
OG0003695	1	0	1	1	2	1	6
OG0003696	2	0	1	1	1	1	6
OG0003697	2	0	1	1	1	1	6
OG0003698	1	0	1	1	0	3	6
OG0003699	1	2	1	1	1	0	6
OG0003700	1	1	0	3	0	1	6
OG0003701	1	1	2	2	0	0	6
OG0003702	1	2	0	0	2	1	6
OG0003703	1	0	1	2	1	1	6
OG0003704	1	1	1	1	1	1	6
OG0003705	1	1	1	1	1	1	6
OG0003706	1	0	1	1	1	2	6
OG0003707	1	1	1	1	1	1	6
OG0003708	1	2	1	1	1	0	6
OG0003709	1	1	1	1	1	1	6
OG0003710	1	0	1	3	0	1	6
OG0003711	1	0	0	3	1	1	6
OG0003712	1	1	1	1	1	1	6
OG0003713	1	0	1	1	2	1	6
OG0003714	3	0	1	1	0	1	6
OG0003715	1	0	2	0	2	1	6
OG0003716	1	0	1	2	1	1	6
OG0003717	1	1	1	1	1	1	6
OG0003718	1	2	1	0	1	1	6
OG0003719	1	0	1	0	2	2	6
OG0003720	1	1	0	2	1	1	6
OG0003721	1	1	1	1	1	1	6
OG0003722	2	1	1	1	1	0	6
OG0003723	2	0	2	0	1	1	6
OG0003724	3	0	1	0	1	1	6
OG0003725	1	1	1	0	1	2	6
OG0003726	1	1	1	2	0	1	6
OG0003727	1	1	1	1	1	1	6
OG0003728	2	0	1	0	1	2	6
OG0003729	2	1	1	1	1	0	6
OG0003730	1	0	2	1	1	1	6
OG0003731	2	0	1	1	1	1	6
OG0003732	1	2	1	1	1	0	6
OG0003733	1	0	1	1	2	1	6
OG0003734	1	1	1	1	1	1	6
OG0003735	1	0	1	2	0	2	6
OG0003736	1	1	1	2	0	1	6
OG0003737	1	0	1	1	1	2	6
OG0003738	3	2	1	0	0	0	6
OG0003739	1	1	1	1	1	1	6
OG0003740	1	1	1	1	1	1	6
OG0003741	1	1	1	1	1	1	6
OG0003742	1	1	1	1	1	1	6
OG0003743	1	1	1	1	1	1	6
OG0003744	1	1	1	1	1	1	6
OG0003745	1	1	1	1	1	1	6
OG0003746	1	1	0	1	2	1	6
OG0003747	1	3	1	1	0	0	6
OG0003748	1	1	1	1	1	1	6
OG0003749	1	1	1	1	1	1	6
OG0003750	1	1	1	1	1	1	6
OG0003751	1	1	2	1	0	1	6
OG0003752	1	2	1	1	0	1	6
OG0003753	1	2	1	0	1	1	6
OG0003754	2	0	1	2	0	1	6
OG0003755	1	0	1	1	0	3	6
OG0003756	1	1	1	0	1	2	6
OG0003757	1	1	1	1	1	1	6
OG0003758	1	1	1	1	1	1	6
OG0003759	1	1	1	1	1	1	6
OG0003760	1	1	1	1	1	1	6
OG0003761	1	1	2	1	1	0	6
OG0003762	1	1	1	1	1	1	6
OG0003763	1	1	1	0	1	2	6
OG0003764	2	1	0	1	1	1	6
OG0003765	1	1	0	2	1	1	6
OG0003766	1	1	0	1	1	2	6
OG0003767	2	1	0	1	1	1	6
OG0003768	1	2	1	1	1	0	6
OG0003769	1	0	1	1	2	1	6
OG0003770	2	1	1	0	1	1	6
OG0003771	2	0	2	1	1	0	6
OG0003772	1	0	1	2	1	1	6
OG0003773	1	1	1	1	1	1	6
OG0003774	1	1	1	1	1	1	6
OG0003775	2	0	1	0	1	2	6
OG0003776	1	1	1	1	1	1	6
OG0003777	1	1	1	1	1	1	6
OG0003778	1	1	1	1	1	1	6
OG0003779	1	0	1	1	2	1	6
OG0003780	1	1	1	1	2	0	6
OG0003781	1	1	1	1	1	1	6
OG0003782	2	1	1	0	2	0	6
OG0003783	1	1	1	1	1	1	6
OG0003784	1	1	1	2	1	0	6
OG0003785	1	0	1	2	1	1	6
OG0003786	1	1	1	1	1	1	6
OG0003787	1	1	1	1	1	1	6
OG0003788	1	1	1	2	1	0	6
OG0003789	1	1	1	1	1	1	6
OG0003790	1	1	1	2	0	1	6
OG0003791	1	2	1	1	0	1	6
OG0003792	1	1	1	1	1	1	6
OG0003793	1	2	1	1	1	0	6
OG0003794	1	1	1	0	1	2	6
OG0003795	2	0	1	1	1	1	6
OG0003796	1	1	1	0	1	2	6
OG0003797	1	1	1	1	1	1	6
OG0003798	2	2	1	0	1	0	6
OG0003799	1	1	0	2	1	1	6
OG0003800	2	1	1	1	1	0	6
OG0003801	1	0	1	1	1	2	6
OG0003802	1	1	1	1	1	1	6
OG0003803	1	1	1	1	1	1	6
OG0003804	2	0	1	1	1	1	6
OG0003805	2	1	3	0	0	0	6
OG0003806	1	1	1	1	1	1	6
OG0003807	1	1	1	2	1	0	6
OG0003808	1	1	1	1	1	1	6
OG0003809	1	2	1	0	2	0	6
OG0003810	1	0	1	2	1	1	6
OG0003811	1	1	1	1	1	1	6
OG0003812	1	1	1	1	1	1	6
OG0003813	1	0	1	1	2	1	6
OG0003814	1	0	1	1	2	1	6
OG0003815	1	0	1	2	2	0	6
OG0003816	1	1	1	1	1	1	6
OG0003817	1	1	1	1	1	1	6
OG0003818	1	0	1	2	1	1	6
OG0003819	1	1	2	1	0	1	6
OG0003820	2	1	1	1	0	1	6
OG0003821	1	2	1	1	0	1	6
OG0003822	1	0	1	0	2	2	6
OG0003823	1	1	1	1	1	1	6
OG0003824	1	2	1	2	0	0	6
OG0003825	6	0	0	0	0	0	6
OG0003826	1	1	1	2	1	0	6
OG0003827	1	1	1	1	1	1	6
OG0003828	2	0	1	1	1	1	6
OG0003829	1	2	1	1	0	1	6
OG0003830	1	1	0	2	1	1	6
OG0003831	1	2	1	2	0	0	6
OG0003832	2	1	1	0	1	1	6
OG0003833	2	1	1	1	1	0	6
OG0003834	1	1	1	1	1	1	6
OG0003835	1	2	1	0	1	1	6
OG0003836	1	1	1	0	1	2	6
OG0003837	1	1	1	1	1	1	6
OG0003838	3	3	0	0	0	0	6
OG0003839	1	1	1	1	1	1	6
OG0003840	1	1	1	1	1	1	6
OG0003841	1	0	1	1	1	2	6
OG0003842	1	1	1	1	1	1	6
OG0003843	1	1	1	0	1	2	6
OG0003844	2	1	1	1	0	1	6
OG0003845	1	1	1	1	1	1	6
OG0003846	1	0	1	1	1	2	6
OG0003847	1	1	1	1	1	1	6
OG0003848	1	0	1	2	1	1	6
OG0003849	2	1	1	1	0	1	6
OG0003850	2	1	1	1	1	0	6
OG0003851	1	1	1	1	1	1	6
OG0003852	1	0	1	1	2	1	6
OG0003853	1	0	2	1	1	1	6
OG0003854	2	0	2	0	1	1	6
OG0003855	1	1	1	1	1	1	6
OG0003856	1	1	1	1	1	1	6
OG0003857	1	2	1	0	1	1	6
OG0003858	1	1	1	1	1	1	6
OG0003859	1	1	1	1	1	1	6
OG0003860	1	1	1	1	1	1	6
OG0003861	1	0	1	1	2	1	6
OG0003862	2	0	1	1	1	1	6
OG0003863	1	0	1	2	1	1	6
OG0003864	1	1	1	1	1	1	6
OG0003865	1	2	0	1	1	1	6
OG0003866	1	0	1	2	1	1	6
OG0003867	1	1	1	1	1	1	6
OG0003868	2	0	1	1	1	1	6
OG0003869	2	1	1	0	1	1	6
OG0003870	2	0	1	1	0	2	6
OG0003871	1	1	1	1	1	1	6
OG0003872	1	1	1	1	1	1	6
OG0003873	2	1	1	2	0	0	6
OG0003874	1	1	1	1	1	1	6
OG0003875	1	2	0	1	1	1	6
OG0003876	1	0	1	2	1	1	6
OG0003877	3	2	0	1	0	0	6
OG0003878	1	1	1	1	1	1	6
OG0003879	2	1	1	0	1	1	6
OG0003880	1	0	1	1	1	2	6
OG0003881	1	1	1	1	1	1	6
OG0003882	2	1	1	0	1	1	6
OG0003883	1	0	1	2	1	1	6
OG0003884	1	0	1	3	1	0	6
OG0003885	1	0	1	2	1	1	6
OG0003886	1	0	1	2	1	1	6
OG0003887	1	0	1	1	2	1	6
OG0003888	1	0	1	1	1	2	6
OG0003889	1	0	2	1	1	1	6
OG0003890	2	0	1	1	0	2	6
OG0003891	2	1	1	1	1	0	6
OG0003892	2	0	1	1	1	1	6
OG0003893	2	0	1	1	1	1	6
OG0003894	2	1	1	1	0	1	6
OG0003895	1	1	1	1	1	1	6
OG0003896	1	1	1	1	0	2	6
OG0003897	1	1	1	1	1	1	6
OG0003898	1	1	1	0	1	2	6
OG0003899	2	1	1	1	1	0	6
OG0003900	2	1	1	1	0	1	6
OG0003901	1	1	1	1	1	1	6
OG0003902	1	0	1	1	1	2	6
OG0003903	3	0	1	1	0	1	6
OG0003904	1	0	1	3	1	0	6
OG0003905	1	1	1	1	1	1	6
OG0003906	1	1	1	1	1	1	6
OG0003907	1	1	1	1	1	1	6
OG0003908	1	0	1	2	0	2	6
OG0003909	1	1	0	1	1	2	6
OG0003910	1	1	1	1	1	1	6
OG0003911	4	2	0	0	0	0	6
OG0003912	1	1	1	1	1	1	6
OG0003913	1	1	1	1	1	1	6
OG0003914	1	1	1	1	1	1	6
OG0003915	2	1	1	0	1	1	6
OG0003916	1	1	1	0	1	2	6
OG0003917	2	0	1	1	1	1	6
OG0003918	2	1	1	1	0	1	6
OG0003919	1	1	1	2	1	0	6
OG0003920	1	0	1	2	1	1	6
OG0003921	1	1	1	1	1	1	6
OG0003922	1	1	1	1	1	1	6
OG0003923	1	1	1	1	1	1	6
OG0003924	1	1	1	1	1	1	6
OG0003925	1	1	1	1	0	2	6
OG0003926	2	0	1	1	1	1	6
OG0003927	1	1	1	1	1	1	6
OG0003928	1	1	2	0	1	1	6
OG0003929	1	2	1	0	1	1	6
OG0003930	1	1	1	1	1	1	6
OG0003931	1	2	0	1	1	1	6
OG0003932	1	1	1	1	1	1	6
OG0003933	1	0	1	3	1	0	6
OG0003934	1	1	1	2	1	0	6
OG0003935	1	1	1	1	1	1	6
OG0003936	1	1	1	1	1	1	6
OG0003937	1	1	1	1	1	1	6
OG0003938	1	1	1	2	0	1	6
OG0003939	1	4	1	0	0	0	6
OG0003940	1	2	1	1	1	0	6
OG0003941	1	0	1	1	1	2	6
OG0003942	3	0	0	0	0	3	6
OG0003943	2	2	1	1	0	0	6
OG0003944	1	1	1	2	0	1	6
OG0003945	2	1	1	1	0	1	6
OG0003946	2	2	1	1	0	0	6
OG0003947	1	1	1	1	1	1	6
OG0003948	1	1	1	1	1	1	6
OG0003949	2	1	1	0	1	1	6
OG0003950	1	2	1	0	1	1	6
OG0003951	1	2	1	0	1	1	6
OG0003952	1	0	1	1	1	2	6
OG0003953	1	2	1	0	1	1	6
OG0003954	1	1	1	1	1	1	6
OG0003955	1	1	1	1	1	1	6
OG0003956	1	1	1	1	1	1	6
OG0003957	1	1	1	1	1	1	6
OG0003958	2	2	1	0	1	0	6
OG0003959	2	0	1	1	1	1	6
OG0003960	2	1	1	1	1	0	6
OG0003961	1	1	1	2	1	0	6
OG0003962	1	0	1	2	1	1	6
OG0003963	1	0	1	2	1	1	6
OG0003964	1	1	1	1	1	1	6
OG0003965	1	1	1	1	1	1	6
OG0003966	1	1	1	1	1	1	6
OG0003967	1	1	1	1	1	1	6
OG0003968	1	0	1	2	1	1	6
OG0003969	1	1	1	1	0	2	6
OG0003970	1	3	1	1	0	0	6
OG0003971	1	1	1	1	1	1	6
OG0003972	2	0	1	1	1	1	6
OG0003973	1	2	1	1	0	1	6
OG0003974	3	0	1	1	1	0	6
OG0003975	1	1	1	1	1	1	6
OG0003976	1	1	1	1	1	1	6
OG0003977	1	0	1	2	1	1	6
OG0003978	1	1	1	1	1	1	6
OG0003979	1	1	1	1	1	1	6
OG0003980	1	0	1	1	2	1	6
OG0003981	1	1	1	1	1	1	6
OG0003982	1	1	1	1	1	1	6
OG0003983	1	0	1	1	3	0	6
OG0003984	1	1	1	1	1	1	6
OG0003985	1	1	1	1	1	1	6
OG0003986	1	0	2	1	1	1	6
OG0003987	1	2	1	0	1	1	6
OG0003988	1	3	1	0	0	1	6
OG0003989	1	0	1	2	0	2	6
OG0003990	1	1	1	1	1	1	6
OG0003991	1	0	1	2	1	1	6
OG0003992	1	1	1	1	1	1	6
OG0003993	2	1	1	1	0	1	6
OG0003994	1	0	1	1	1	2	6
OG0003995	1	1	1	1	1	1	6
OG0003996	1	0	1	0	2	2	6
OG0003997	1	0	1	1	1	2	6
OG0003998	1	1	1	1	1	1	6
OG0003999	1	0	2	2	0	1	6
OG0004000	1	1	1	2	0	1	6
OG0004001	1	2	1	1	0	1	6
OG0004002	1	1	1	1	1	1	6
OG0004003	1	1	1	1	1	1	6
OG0004004	1	0	1	1	2	1	6
OG0004005	1	1	1	1	1	1	6
OG0004006	1	1	1	2	0	1	6
OG0004007	1	0	1	0	2	2	6
OG0004008	1	1	1	1	1	1	6
OG0004009	1	1	2	1	1	0	6
OG0004010	1	1	1	1	1	1	6
OG0004011	1	1	1	1	1	1	6
OG0004012	1	1	1	1	1	1	6
OG0004013	1	0	1	2	1	1	6
OG0004014	1	1	1	1	1	1	6
OG0004015	1	1	1	1	1	1	6
OG0004016	1	1	1	2	1	0	6
OG0004017	1	1	1	1	1	1	6
OG0004018	1	1	1	1	1	1	6
OG0004019	1	1	1	1	1	1	6
OG0004020	2	0	1	1	1	1	6
OG0004021	2	1	1	0	1	1	6
OG0004022	1	1	1	1	1	1	6
OG0004023	1	1	1	1	1	1	6
OG0004024	1	1	1	2	1	0	6
OG0004025	2	0	1	1	1	1	6
OG0004026	1	1	1	1	1	1	6
OG0004027	1	0	1	1	1	2	6
OG0004028	1	1	1	1	2	0	6
OG0004029	1	0	1	1	1	2	6
OG0004030	1	1	1	1	1	1	6
OG0004031	1	1	1	0	1	2	6
OG0004032	1	1	1	2	1	0	6
OG0004033	1	1	1	1	1	1	6
OG0004034	3	1	0	0	2	0	6
OG0004035	1	1	1	1	1	1	6
OG0004036	1	1	1	0	1	2	6
OG0004037	2	1	1	1	1	0	6
OG0004038	1	0	1	1	1	2	6
OG0004039	1	1	1	1	1	1	6
OG0004040	1	1	1	1	1	1	6
OG0004041	1	1	1	2	0	1	6
OG0004042	1	1	1	1	1	1	6
OG0004043	1	1	1	2	1	0	6
OG0004044	1	1	1	1	1	1	6
OG0004045	1	1	2	2	0	0	6
OG0004046	1	0	0	1	1	3	6
OG0004047	1	1	1	1	1	1	6
OG0004048	2	1	1	0	1	1	6
OG0004049	1	2	0	1	1	1	6
OG0004050	1	1	1	1	1	1	6
OG0004051	1	2	1	1	0	1	6
OG0004052	1	1	1	1	1	1	6
OG0004053	1	0	1	1	2	1	6
OG0004054	1	1	1	1	1	1	6
OG0004055	1	1	1	1	1	1	6
OG0004056	1	0	1	1	1	2	6
OG0004057	1	1	1	1	1	1	6
OG0004058	1	1	1	0	2	1	6
OG0004059	1	1	1	1	1	1	6
OG0004060	1	1	2	1	1	0	6
OG0004061	1	2	1	0	1	1	6
OG0004062	1	1	1	1	1	1	6
OG0004063	1	1	1	1	1	1	6
OG0004064	1	1	1	1	0	2	6
OG0004065	1	2	1	1	1	0	6
OG0004066	1	1	1	1	1	1	6
OG0004067	1	0	1	1	1	2	6
OG0004068	1	1	1	1	1	1	6
OG0004069	1	1	1	1	1	1	6
OG0004070	1	0	2	1	1	1	6
OG0004071	1	0	1	1	2	1	6
OG0004072	1	1	1	1	1	1	6
OG0004073	1	2	1	1	0	1	6
OG0004074	1	1	1	2	0	1	6
OG0004075	1	1	1	1	1	1	6
OG0004076	1	1	1	1	1	1	6
OG0004077	1	1	1	2	1	0	6
OG0004078	1	0	1	2	1	1	6
OG0004079	1	1	0	0	1	3	6
OG0004080	1	2	1	2	0	0	6
OG0004081	1	2	1	1	1	0	6
OG0004082	1	0	1	1	2	1	6
OG0004083	1	2	1	1	0	1	6
OG0004084	1	2	1	1	0	1	6
OG0004085	1	1	1	1	1	1	6
OG0004086	1	1	1	1	1	1	6
OG0004087	1	1	1	1	1	1	6
OG0004088	1	1	1	1	1	1	6
OG0004089	1	0	1	2	1	1	6
OG0004090	1	1	2	1	1	0	6
OG0004091	1	1	1	1	1	1	6
OG0004092	1	2	1	1	0	1	6
OG0004093	1	1	1	2	1	0	6
OG0004094	1	1	1	1	1	1	6
OG0004095	1	1	1	1	1	1	6
OG0004096	1	1	1	1	1	1	6
OG0004097	1	1	1	1	1	1	6
OG0004098	1	1	1	1	1	1	6
OG0004099	1	1	1	2	0	1	6
OG0004100	1	1	1	2	0	1	6
OG0004101	1	1	1	1	1	1	6
OG0004102	1	1	1	1	1	1	6
OG0004103	1	1	1	1	1	1	6
OG0004104	1	0	1	1	1	2	6
OG0004105	1	1	1	1	1	1	6
OG0004106	1	1	1	1	1	1	6
OG0004107	1	0	2	2	1	0	6
OG0004108	2	0	1	2	1	0	6
OG0004109	1	1	1	1	0	2	6
OG0004110	1	1	1	1	2	0	6
OG0004111	3	0	1	1	0	1	6
OG0004112	1	1	1	1	1	1	6
OG0004113	1	1	1	1	1	1	6
OG0004114	1	0	1	2	1	1	6
OG0004115	3	0	1	2	0	0	6
OG0004116	1	1	1	1	1	1	6
OG0004117	1	1	1	1	1	1	6
OG0004118	1	1	1	1	1	1	6
OG0004119	1	2	1	0	1	1	6
OG0004120	1	1	1	1	1	1	6
OG0004121	1	1	1	1	1	1	6
OG0004122	1	1	1	1	1	1	6
OG0004123	1	1	1	1	1	1	6
OG0004124	1	1	1	2	1	0	6
OG0004125	2	0	1	0	1	2	6
OG0004126	2	0	1	1	1	1	6
OG0004127	1	1	1	1	1	1	6
OG0004128	1	0	1	2	1	1	6
OG0004129	1	2	1	1	1	0	6
OG0004130	1	1	1	1	0	2	6
OG0004131	1	1	1	1	1	1	6
OG0004132	2	1	1	1	1	0	6
OG0004133	1	1	1	1	1	1	6
OG0004134	1	1	2	0	1	1	6
OG0004135	1	2	1	0	1	1	6
OG0004136	1	1	1	1	1	1	6
OG0004137	1	0	2	0	2	1	6
OG0004138	2	1	1	0	1	1	6
OG0004139	1	0	5	0	0	0	6
OG0004140	1	1	1	1	1	1	6
OG0004141	1	1	1	1	1	1	6
OG0004142	1	3	1	0	0	1	6
OG0004143	1	1	1	1	1	1	6
OG0004144	1	1	1	2	0	1	6
OG0004145	1	0	1	2	1	1	6
OG0004146	1	2	1	1	0	1	6
OG0004147	1	1	1	1	1	1	6
OG0004148	1	1	1	1	1	1	6
OG0004149	1	0	1	2	1	1	6
OG0004150	1	1	1	2	0	1	6
OG0004151	1	1	1	1	1	1	6
OG0004152	1	1	1	1	1	1	6
OG0004153	1	2	1	1	1	0	6
OG0004154	1	0	1	1	3	0	6
OG0004155	1	1	1	1	1	1	6
OG0004156	1	0	1	2	1	1	6
OG0004157	1	0	1	2	1	1	6
OG0004158	1	0	1	1	2	1	6
OG0004159	1	0	2	1	1	1	6
OG0004160	1	1	1	1	1	1	6
OG0004161	1	1	1	1	1	1	6
OG0004162	1	0	1	1	2	1	6
OG0004163	1	2	1	1	0	1	6
OG0004164	2	1	1	1	0	1	6
OG0004165	1	1	1	1	0	2	6
OG0004166	1	1	1	1	1	1	6
OG0004167	1	0	2	1	1	1	6
OG0004168	1	1	1	2	1	0	6
OG0004169	1	0	1	1	1	2	6
OG0004170	1	1	2	1	0	1	6
OG0004171	1	0	1	1	2	1	6
OG0004172	1	2	1	0	1	1	6
OG0004173	1	1	1	1	1	1	6
OG0004174	1	1	1	1	1	1	6
OG0004175	1	1	1	1	1	1	6
OG0004176	1	1	1	1	1	1	6
OG0004177	1	2	1	1	0	1	6
OG0004178	1	0	1	3	0	1	6
OG0004179	2	0	1	1	1	1	6
OG0004180	1	1	1	1	1	1	6
OG0004181	1	2	1	1	1	0	6
OG0004182	1	1	1	1	1	1	6
OG0004183	1	1	1	1	1	1	6
OG0004184	1	0	2	1	1	1	6
OG0004185	1	1	1	0	2	1	6
OG0004186	1	1	1	1	1	1	6
OG0004187	1	0	1	2	1	1	6
OG0004188	1	1	1	1	1	1	6
OG0004189	1	1	1	1	1	1	6
OG0004190	1	1	1	0	2	1	6
OG0004191	1	3	0	2	0	0	6
OG0004192	1	0	1	1	2	1	6
OG0004193	1	1	0	0	1	3	6
OG0004194	1	1	1	2	1	0	6
OG0004195	1	1	1	1	1	1	6
OG0004196	1	1	0	2	1	1	6
OG0004197	1	1	1	1	1	1	6
OG0004198	1	1	1	0	1	2	6
OG0004199	1	1	1	1	1	1	6
OG0004200	1	2	1	0	1	1	6
OG0004201	1	1	1	1	1	1	6
OG0004202	1	2	1	0	1	1	6
OG0004203	1	1	1	0	1	2	6
OG0004204	3	3	0	0	0	0	6
OG0004205	1	0	1	1	1	2	6
OG0004206	1	0	1	2	1	1	6
OG0004207	3	0	1	1	1	0	6
OG0004208	2	0	1	1	1	1	6
OG0004209	1	0	1	1	2	1	6
OG0004210	1	1	1	1	1	1	6
OG0004211	2	0	1	1	1	1	6
OG0004212	2	1	1	1	1	0	6
OG0004213	1	1	1	1	1	1	6
OG0004214	1	0	2	2	1	0	6
OG0004215	1	0	1	1	2	1	6
OG0004216	1	1	1	1	1	1	6
OG0004217	1	0	1	1	2	1	6
OG0004218	1	2	1	1	0	1	6
OG0004219	1	0	1	2	2	0	6
OG0004220	1	0	1	1	2	1	6
OG0004221	1	1	1	1	1	1	6
OG0004222	1	0	1	1	2	1	6
OG0004223	1	1	1	1	1	1	6
OG0004224	1	1	1	1	1	1	6
OG0004225	1	1	1	1	1	1	6
OG0004226	1	1	1	1	2	0	6
OG0004227	2	1	1	1	1	0	6
OG0004228	1	1	1	1	1	1	6
OG0004229	1	1	1	1	1	1	6
OG0004230	1	0	1	1	3	0	6
OG0004231	1	1	1	1	1	1	6
OG0004232	2	0	4	0	0	0	6
OG0004233	1	1	1	0	2	1	6
OG0004234	1	3	1	0	1	0	6
OG0004235	1	2	1	1	0	1	6
OG0004236	1	1	1	1	1	1	6
OG0004237	1	0	1	2	1	1	6
OG0004238	2	1	1	1	0	1	6
OG0004239	2	0	1	1	1	1	6
OG0004240	1	0	1	0	3	1	6
OG0004241	2	1	1	0	1	1	6
OG0004242	1	0	2	1	1	1	6
OG0004243	1	1	1	1	1	1	6
OG0004244	1	1	1	2	1	0	6
OG0004245	1	1	1	0	2	1	6
OG0004246	2	0	1	0	2	1	6
OG0004247	1	1	1	1	1	1	6
OG0004248	1	1	1	1	1	1	6
OG0004249	1	0	1	2	0	2	6
OG0004250	1	1	1	1	1	1	6
OG0004251	1	1	1	2	1	0	6
OG0004252	1	0	1	0	1	3	6
OG0004253	1	1	1	1	1	1	6
OG0004254	1	1	1	1	1	1	6
OG0004255	1	1	1	1	1	1	6
OG0004256	1	1	1	1	1	1	6
OG0004257	1	0	1	1	1	2	6
OG0004258	1	1	1	1	0	2	6
OG0004259	1	0	1	1	1	2	6
OG0004260	1	1	1	0	2	1	6
OG0004261	1	1	1	0	3	0	6
OG0004262	1	1	1	1	1	1	6
OG0004263	1	1	1	2	1	0	6
OG0004264	1	1	1	1	0	2	6
OG0004265	1	2	1	0	1	1	6
OG0004266	1	0	1	1	2	1	6
OG0004267	1	1	1	1	1	1	6
OG0004268	1	1	1	1	1	1	6
OG0004269	1	1	1	1	1	1	6
OG0004270	1	1	1	1	1	1	6
OG0004271	1	0	2	2	1	0	6
OG0004272	1	0	1	1	2	1	6
OG0004273	1	0	1	1	1	2	6
OG0004274	1	1	1	1	0	2	6
OG0004275	1	1	1	1	1	1	6
OG0004276	1	2	1	1	0	1	6
OG0004277	2	0	1	1	1	1	6
OG0004278	1	2	1	2	0	0	6
OG0004279	1	0	1	2	1	1	6
OG0004280	1	1	1	1	1	1	6
OG0004281	1	1	1	0	1	2	6
OG0004282	1	2	1	1	0	1	6
OG0004283	1	1	1	1	1	1	6
OG0004284	1	1	2	2	0	0	6
OG0004285	1	1	1	1	1	1	6
OG0004286	1	1	1	1	1	1	6
OG0004287	1	1	1	1	1	1	6
OG0004288	1	0	1	2	1	1	6
OG0004289	1	1	1	1	1	1	6
OG0004290	1	0	1	1	2	1	6
OG0004291	1	0	1	1	1	2	6
OG0004292	1	0	1	1	1	2	6
OG0004293	1	0	1	2	0	2	6
OG0004294	1	1	1	2	0	1	6
OG0004295	1	1	1	1	2	0	6
OG0004296	1	2	1	1	1	0	6
OG0004297	1	0	1	2	2	0	6
OG0004298	1	2	1	1	0	1	6
OG0004299	1	1	1	1	1	1	6
OG0004300	1	2	1	0	0	2	6
OG0004301	1	0	1	1	1	2	6
OG0004302	1	1	1	1	1	1	6
OG0004303	1	1	1	1	1	1	6
OG0004304	1	0	1	2	1	1	6
OG0004305	1	2	1	1	0	1	6
OG0004306	1	4	1	0	0	0	6
OG0004307	1	1	1	1	1	1	6
OG0004308	1	0	1	3	1	0	6
OG0004309	1	1	1	1	1	1	6
OG0004310	1	1	1	0	2	1	6
OG0004311	1	1	1	0	2	1	6
OG0004312	1	1	1	1	1	1	6
OG0004313	1	1	1	1	1	1	6
OG0004314	1	2	1	0	1	1	6
OG0004315	1	2	1	0	1	1	6
OG0004316	1	1	1	1	1	1	6
OG0004317	1	0	1	1	2	1	6
OG0004318	1	1	1	2	0	1	6
OG0004319	1	0	1	1	1	2	6
OG0004320	1	1	1	1	1	1	6
OG0004321	1	0	1	2	1	1	6
OG0004322	1	1	1	1	2	0	6
OG0004323	1	1	1	1	1	1	6
OG0004324	1	1	1	1	1	1	6
OG0004325	1	1	1	1	1	1	6
OG0004326	1	0	1	1	2	1	6
OG0004327	1	1	1	1	1	1	6
OG0004328	1	1	1	1	2	0	6
OG0004329	1	1	1	2	0	1	6
OG0004330	1	2	1	1	1	0	6
OG0004331	1	0	1	1	2	1	6
OG0004332	1	1	1	1	1	1	6
OG0004333	1	1	1	1	1	1	6
OG0004334	1	0	1	1	1	2	6
OG0004335	1	3	0	1	0	1	6
OG0004336	1	1	1	0	1	2	6
OG0004337	1	1	1	1	1	1	6
OG0004338	2	1	1	1	1	0	6
OG0004339	1	1	1	1	1	1	6
OG0004340	1	2	1	0	1	1	6
OG0004341	1	1	1	1	1	1	6
OG0004342	1	2	1	0	2	0	6
OG0004343	1	2	0	1	1	1	6
OG0004344	2	1	1	1	1	0	6
OG0004345	1	0	1	1	2	1	6
OG0004346	1	0	1	1	1	2	6
OG0004347	1	1	1	1	1	1	6
OG0004348	1	1	1	1	1	1	6
OG0004349	1	1	1	1	1	1	6
OG0004350	1	1	1	1	1	1	6
OG0004351	1	0	1	1	1	2	6
OG0004352	1	1	1	1	1	1	6
OG0004353	1	0	1	2	1	1	6
OG0004354	1	2	1	1	0	1	6
OG0004355	1	2	1	1	1	0	6
OG0004356	1	1	1	1	1	1	6
OG0004357	1	0	1	2	1	1	6
OG0004358	1	1	1	1	1	1	6
OG0004359	1	1	1	1	1	1	6
OG0004360	1	1	1	1	1	1	6
OG0004361	1	1	1	3	0	0	6
OG0004362	1	1	1	1	1	1	6
OG0004363	1	0	1	1	1	2	6
OG0004364	1	1	1	1	1	1	6
OG0004365	1	0	1	2	1	1	6
OG0004366	1	0	1	1	2	1	6
OG0004367	1	0	2	1	1	1	6
OG0004368	1	1	1	2	1	0	6
OG0004369	1	1	1	1	1	1	6
OG0004370	1	1	1	1	1	1	6
OG0004371	1	1	1	1	1	1	6
OG0004372	1	1	1	1	1	1	6
OG0004373	1	2	1	1	1	0	6
OG0004374	1	1	1	1	1	1	6
OG0004375	1	1	1	1	1	1	6
OG0004376	1	1	1	1	1	1	6
OG0004377	1	0	1	2	1	1	6
OG0004378	1	1	1	2	1	0	6
OG0004379	1	1	1	1	1	1	6
OG0004380	1	1	1	1	1	1	6
OG0004381	1	1	1	1	1	1	6
OG0004382	1	1	1	1	1	1	6
OG0004383	1	1	1	0	2	1	6
OG0004384	1	1	1	1	1	1	6
OG0004385	1	0	1	1	2	1	6
OG0004386	1	0	1	1	1	2	6
OG0004387	1	0	1	3	1	0	6
OG0004388	1	0	1	2	1	1	6
OG0004389	1	1	1	1	1	1	6
OG0004390	1	2	1	1	1	0	6
OG0004391	1	0	1	1	2	1	6
OG0004392	1	3	1	0	1	0	6
OG0004393	1	1	1	0	1	2	6
OG0004394	1	2	1	0	0	2	6
OG0004395	2	1	1	1	0	1	6
OG0004396	1	1	1	2	0	1	6
OG0004397	1	1	1	1	1	1	6
OG0004398	1	0	1	1	2	1	6
OG0004399	1	1	1	1	1	1	6
OG0004400	1	3	1	0	0	1	6
OG0004401	1	1	1	1	1	1	6
OG0004402	1	1	1	1	1	1	6
OG0004403	1	1	1	1	1	1	6
OG0004404	1	1	1	1	1	1	6
OG0004405	1	1	1	1	1	1	6
OG0004406	1	1	1	1	1	1	6
OG0004407	1	1	1	1	1	1	6
OG0004408	1	1	1	1	1	1	6
OG0004409	1	2	1	1	0	1	6
OG0004410	1	1	1	1	1	1	6
OG0004411	1	0	1	2	1	1	6
OG0004412	1	1	1	0	2	1	6
OG0004413	1	1	1	2	0	1	6
OG0004414	1	0	1	0	3	1	6
OG0004415	1	1	1	1	1	1	6
OG0004416	1	1	1	2	1	0	6
OG0004417	1	1	1	1	1	1	6
OG0004418	1	0	1	3	0	1	6
OG0004419	1	0	1	1	2	1	6
OG0004420	1	1	1	1	1	1	6
OG0004421	1	1	1	1	1	1	6
OG0004422	1	0	1	2	1	1	6
OG0004423	1	1	2	0	1	1	6
OG0004424	1	2	0	0	0	3	6
OG0004425	1	1	2	0	1	1	6
OG0004426	1	0	1	1	1	2	6
OG0004427	1	1	1	1	1	1	6
OG0004428	1	0	2	1	1	1	6
OG0004429	1	1	1	1	1	1	6
OG0004430	1	1	1	1	0	2	6
OG0004431	1	1	1	1	1	1	6
OG0004432	1	1	1	1	1	1	6
OG0004433	1	1	1	1	1	1	6
OG0004434	1	1	1	2	0	1	6
OG0004435	1	1	1	1	1	1	6
OG0004436	1	1	1	1	1	1	6
OG0004437	1	1	1	1	1	1	6
OG0004438	1	1	1	1	1	1	6
OG0004439	1	1	1	1	1	1	6
OG0004440	1	1	1	1	2	0	6
OG0004441	1	0	1	2	1	1	6
OG0004442	1	2	1	1	0	1	6
OG0004443	1	1	1	1	1	1	6
OG0004444	1	2	1	0	1	1	6
OG0004445	1	1	1	1	1	1	6
OG0004446	2	0	1	1	1	1	6
OG0004447	1	1	1	1	1	1	6
OG0004448	1	1	1	1	0	2	6
OG0004449	1	1	1	1	1	1	6
OG0004450	0	2	1	0	1	2	6
OG0004451	0	2	1	0	1	2	6
OG0004452	0	2	2	0	2	0	6
OG0004453	0	1	1	1	2	1	6
OG0004454	0	1	1	0	1	3	6
OG0004455	0	1	1	1	2	1	6
OG0004456	0	1	1	1	2	1	6
OG0004457	0	1	0	1	2	2	6
OG0004458	0	1	2	1	1	1	6
OG0004459	0	1	1	1	1	2	6
OG0004460	0	2	1	2	1	0	6
OG0004461	0	2	1	1	1	1	6
OG0004462	0	1	1	1	2	1	6
OG0004463	0	1	1	3	1	0	6
OG0004464	0	1	1	1	2	1	6
OG0004465	0	3	1	2	0	0	6
OG0004466	0	2	1	1	1	1	6
OG0004467	0	2	1	1	1	1	6
OG0004468	0	1	1	1	2	1	6
OG0004469	0	1	1	1	2	1	6
OG0004470	0	2	1	0	1	2	6
OG0004471	0	1	1	1	1	2	6
OG0004472	0	2	1	2	1	0	6
OG0004473	0	1	1	2	1	1	6
OG0004474	0	4	1	1	0	0	6
OG0004475	0	1	2	1	1	1	6
OG0004476	0	1	1	3	0	1	6
OG0004477	0	1	0	0	0	5	6
OG0004478	0	1	1	2	1	1	6
OG0004479	0	1	1	1	1	2	6
OG0004480	0	3	1	0	1	1	6
OG0004481	0	2	1	1	1	1	6
OG0004482	0	1	1	2	0	2	6
OG0004483	0	2	1	2	0	1	6
OG0004484	0	1	0	2	1	2	6
OG0004485	0	1	2	1	0	2	6
OG0004486	0	2	1	2	0	1	6
OG0004487	0	2	1	1	1	1	6
OG0004488	0	1	1	1	2	1	6
OG0004489	0	1	1	1	1	2	6
OG0004490	0	1	2	1	1	1	6
OG0004491	0	2	1	2	0	1	6
OG0004492	0	1	1	2	1	1	6
OG0004493	0	3	1	1	1	0	6
OG0004494	0	1	1	2	1	1	6
OG0004495	0	2	1	2	1	0	6
OG0004496	0	1	1	1	2	1	6
OG0004497	0	1	1	2	1	1	6
OG0004498	0	2	1	0	2	1	6
OG0004499	0	3	1	0	2	0	6
OG0004500	0	3	0	2	1	0	6
OG0004501	0	3	1	1	0	1	6
OG0004502	0	1	1	2	1	1	6
OG0004503	0	1	0	2	2	1	6
OG0004504	0	3	1	0	1	1	6
OG0004505	0	2	2	0	1	1	6
OG0004506	0	1	1	2	1	1	6
OG0004507	0	2	1	1	1	1	6
OG0004508	0	2	1	1	1	1	6
OG0004509	0	1	1	2	1	1	6
OG0004510	0	1	2	1	1	1	6
OG0004511	0	1	2	1	1	1	6
OG0004512	0	2	1	1	2	0	6
OG0004513	0	2	1	1	0	2	6
OG0004514	0	1	1	1	1	2	6
OG0004515	0	2	1	0	1	2	6
OG0004516	0	1	1	1	2	1	6
OG0004517	0	2	1	1	1	1	6
OG0004518	0	1	1	1	1	2	6
OG0004519	0	1	1	2	1	1	6
OG0004520	0	2	1	1	1	1	6
OG0004521	0	2	1	1	1	1	6
OG0004522	0	1	1	2	2	0	6
OG0004523	0	3	1	0	2	0	6
OG0004524	0	1	1	2	1	1	6
OG0004525	0	2	0	1	2	1	6
OG0004526	0	3	1	1	1	0	6
OG0004527	0	2	1	1	1	1	6
OG0004528	0	4	1	0	1	0	6
OG0004529	0	1	1	1	2	1	6
OG0004530	0	1	1	2	1	1	6
OG0004531	0	1	1	1	1	2	6
OG0004532	0	1	1	2	1	1	6
OG0004533	0	1	1	1	1	2	6
OG0004534	0	3	1	1	1	0	6
OG0004535	0	4	0	1	1	0	6
OG0004536	0	1	2	1	1	1	6
OG0004537	0	1	1	1	1	2	6
OG0004538	0	1	1	1	1	2	6
OG0004539	0	1	1	1	1	2	6
OG0004540	0	1	1	1	1	2	6
OG0004541	0	2	1	1	1	1	6
OG0004542	0	1	1	1	2	1	6
OG0004543	0	1	1	2	1	1	6
OG0004544	0	2	1	1	0	2	6
OG0004545	0	1	1	2	1	1	6
OG0004546	0	2	1	1	1	1	6
OG0004547	0	1	1	1	2	1	6
OG0004548	0	2	1	0	2	1	6
OG0004549	0	1	1	1	1	2	6
OG0004550	0	2	1	0	2	1	6
OG0004551	0	2	1	1	1	1	6
OG0004552	0	2	1	1	1	1	6
OG0004553	0	1	1	1	2	1	6
OG0004554	0	1	1	0	2	2	6
OG0004555	0	1	1	2	1	1	6
OG0004556	0	6	0	0	0	0	6
OG0004557	0	1	1	2	1	1	6
OG0004558	0	2	1	1	1	1	6
OG0004559	0	1	1	0	2	2	6
OG0004560	0	3	1	0	1	1	6
OG0004561	0	1	1	2	1	1	6
OG0004562	0	2	1	1	1	1	6
OG0004563	0	2	0	1	2	1	6
OG0004564	0	2	1	1	1	1	6
OG0004565	0	1	1	1	2	1	6
OG0004566	0	1	1	1	1	2	6
OG0004567	0	1	1	1	2	1	6
OG0004568	0	2	1	1	1	1	6
OG0004569	0	1	2	1	1	1	6
OG0004570	0	1	1	1	2	1	6
OG0004571	0	2	1	0	2	1	6
OG0004572	0	2	1	0	2	1	6
OG0004573	0	1	1	1	2	1	6
OG0004574	0	2	1	1	1	1	6
OG0004575	0	1	1	1	1	2	6
OG0004576	0	2	1	1	1	1	6
OG0004577	0	1	1	2	1	1	6
OG0004578	0	2	1	1	1	1	6
OG0004579	0	1	1	2	1	1	6
OG0004580	0	2	1	1	1	1	6
OG0004581	0	2	1	1	1	1	6
OG0004582	0	2	1	1	1	1	6
OG0004583	0	1	1	1	2	1	6
OG0004584	0	1	1	2	1	1	6
OG0004585	0	2	1	1	1	1	6
OG0004586	0	1	1	1	1	2	6
OG0004587	0	1	1	1	1	2	6
OG0004588	0	1	1	0	2	2	6
OG0004589	0	3	1	1	0	1	6
OG0004590	0	1	1	2	1	1	6
OG0004591	0	2	1	1	1	1	6
OG0004592	0	1	1	2	1	1	6
OG0004593	0	2	1	1	1	1	6
OG0004594	0	2	1	1	1	1	6
OG0004595	0	1	1	3	0	1	6
OG0004596	0	1	1	2	1	1	6
OG0004597	0	2	1	2	1	0	6
OG0004598	0	2	1	1	1	1	6
OG0004599	0	1	1	2	1	1	6
OG0004600	0	1	1	1	2	1	6
OG0004601	0	3	1	1	1	0	6
OG0004602	0	1	1	1	1	2	6
OG0004603	0	4	1	1	0	0	6
OG0004604	0	1	1	2	1	1	6
OG0004605	0	2	1	1	1	1	6
OG0004606	0	1	1	1	2	1	6
OG0004607	0	2	1	1	1	1	6
OG0004608	0	1	1	2	1	1	6
OG0004609	0	1	2	1	1	1	6
OG0004610	0	1	1	1	1	2	6
OG0004611	0	1	1	1	1	2	6
OG0004612	0	1	2	1	1	1	6
OG0004613	0	1	1	0	3	1	6
OG0004614	0	2	1	0	2	1	6
OG0004615	0	2	1	1	1	1	6
OG0004616	0	2	1	1	2	0	6
OG0004617	0	1	1	2	0	2	6
OG0004618	0	1	0	0	0	5	6
OG0004619	0	5	0	1	0	0	6
OG0004620	0	1	1	2	1	1	6
OG0004621	0	3	1	2	0	0	6
OG0004622	0	3	1	0	1	1	6
OG0004623	0	2	1	1	1	1	6
OG0004624	0	4	0	2	0	0	6
OG0004625	0	2	1	1	1	1	6
OG0004626	0	1	1	2	1	1	6
OG0004627	0	3	1	1	1	0	6
OG0004628	0	2	1	1	1	1	6
OG0004629	0	1	1	1	1	2	6
OG0004630	0	1	2	0	0	3	6
OG0004631	0	1	1	1	0	3	6
OG0004632	0	2	1	0	1	2	6
OG0004633	0	2	1	1	1	1	6
OG0004634	0	2	1	0	2	1	6
OG0004635	0	1	1	0	0	4	6
OG0004636	0	1	1	1	2	1	6
OG0004637	0	2	1	1	1	1	6
OG0004638	0	1	1	1	2	1	6
OG0004639	0	2	1	1	1	1	6
OG0004640	0	1	1	2	1	1	6
OG0004641	0	1	1	1	1	2	6
OG0004642	0	3	0	1	1	1	6
OG0004643	0	1	1	1	2	1	6
OG0004644	0	1	1	2	2	0	6
OG0004645	0	1	1	1	1	2	6
OG0004646	0	1	1	0	3	1	6
OG0004647	0	1	1	2	1	1	6
OG0004648	0	1	1	1	1	2	6
OG0004649	0	2	1	1	2	0	6
OG0004650	0	1	2	1	1	1	6
OG0004651	0	1	1	1	1	2	6
OG0004652	0	2	1	1	1	1	6
OG0004653	0	1	1	2	1	1	6
OG0004654	0	2	1	1	1	1	6
OG0004655	0	2	1	0	2	1	6
OG0004656	0	3	1	1	1	0	6
OG0004657	0	2	0	1	1	2	6
OG0004658	0	2	1	1	1	1	6
OG0004659	0	1	1	2	1	1	6
OG0004660	0	2	1	1	1	1	6
OG0004661	0	1	1	2	1	1	6
OG0004662	0	3	1	1	0	1	6
OG0004663	0	1	1	3	0	1	6
OG0004664	0	1	1	4	0	0	6
OG0004665	0	1	1	0	2	2	6
OG0004666	0	0	1	1	2	2	6
OG0004667	0	0	1	1	1	3	6
OG0004668	0	0	6	0	0	0	6
OG0004669	0	0	1	1	1	3	6
OG0004670	0	0	1	3	1	1	6
OG0004671	0	0	1	3	1	1	6
OG0004672	0	0	6	0	0	0	6
OG0004673	0	0	4	0	1	1	6
OG0004674	0	0	1	1	2	2	6
OG0004675	0	0	1	2	1	2	6
OG0004676	0	0	2	2	1	1	6
OG0004677	0	0	1	2	2	1	6
OG0004678	0	0	1	2	2	1	6
OG0004679	0	0	2	2	1	1	6
OG0004680	0	0	1	2	2	1	6
OG0004681	0	0	1	2	1	2	6
OG0004682	0	0	1	3	1	1	6
OG0004683	0	0	1	2	1	2	6
OG0004684	0	0	1	1	3	1	6
OG0004685	0	0	1	0	2	3	6
OG0004686	0	0	1	1	1	3	6
OG0004687	0	0	1	3	1	1	6
OG0004688	0	0	1	1	1	3	6
OG0004689	0	0	1	0	3	2	6
OG0004690	0	0	1	3	1	1	6
OG0004691	0	0	2	1	1	2	6
OG0004692	0	0	1	1	2	2	6
OG0004693	0	0	1	3	1	1	6
OG0004694	0	0	1	2	1	2	6
OG0004695	0	0	1	1	1	3	6
OG0004696	0	0	1	3	1	1	6
OG0004697	0	0	1	0	4	1	6
OG0004698	0	0	1	2	2	1	6
OG0004699	0	0	1	3	1	1	6
OG0004700	0	0	1	1	2	2	6
OG0004701	0	0	3	2	0	1	6
OG0004702	0	0	1	2	2	1	6
OG0004703	0	0	1	1	2	2	6
OG0004704	0	0	1	2	1	2	6
OG0004705	0	0	1	1	3	1	6
OG0004706	0	0	1	1	2	2	6
OG0004707	0	0	1	3	1	1	6
OG0004708	0	0	1	2	1	2	6
OG0004709	0	0	1	0	2	3	6
OG0004710	0	0	1	3	1	1	6
OG0004711	0	0	1	2	2	1	6
OG0004712	0	0	1	1	2	2	6
OG0004713	0	0	1	2	1	2	6
OG0004714	0	0	1	0	3	2	6
OG0004715	0	0	0	6	0	0	6
OG0004716	0	0	0	6	0	0	6
OG0004717	0	0	0	0	5	1	6
OG0004718	0	0	0	0	6	0	6
OG0004719	0	0	0	0	2	4	6
OG0004720	0	0	0	0	0	6	6
OG0004721	2	0	1	0	1	1	5
OG0004722	1	1	1	1	1	0	5
OG0004723	1	0	1	1	1	1	5
OG0004724	1	0	1	1	1	1	5
OG0004725	1	1	1	1	0	1	5
OG0004726	1	2	1	1	0	0	5
OG0004727	1	0	1	1	1	1	5
OG0004728	2	1	1	1	0	0	5
OG0004729	4	1	0	0	0	0	5
OG0004730	2	1	1	0	0	1	5
OG0004731	1	0	1	1	1	1	5
OG0004732	1	1	1	0	1	1	5
OG0004733	2	0	1	1	1	0	5
OG0004734	2	1	1	1	0	0	5
OG0004735	2	0	1	1	0	1	5
OG0004736	3	0	0	0	0	2	5
OG0004737	3	0	0	0	1	1	5
OG0004738	1	1	1	1	0	1	5
OG0004739	2	2	1	0	0	0	5
OG0004740	1	2	1	0	1	0	5
OG0004741	1	0	1	1	1	1	5
OG0004742	4	1	0	0	0	0	5
OG0004743	1	0	1	0	1	2	5
OG0004744	1	1	1	0	1	1	5
OG0004745	1	1	1	0	1	1	5
OG0004746	2	0	1	1	1	0	5
OG0004747	1	0	1	2	1	0	5
OG0004748	2	0	1	1	0	1	5
OG0004749	1	0	1	1	1	1	5
OG0004750	1	1	0	1	1	1	5
OG0004751	1	0	1	1	1	1	5
OG0004752	1	1	1	0	1	1	5
OG0004753	1	0	1	1	1	1	5
OG0004754	3	0	1	0	1	0	5
OG0004755	1	1	1	0	1	1	5
OG0004756	1	0	1	1	1	1	5
OG0004757	1	2	1	0	1	0	5
OG0004758	1	1	1	0	1	1	5
OG0004759	1	1	1	1	1	0	5
OG0004760	2	0	1	1	1	0	5
OG0004761	2	0	1	1	0	1	5
OG0004762	1	1	1	1	1	0	5
OG0004763	1	0	1	1	1	1	5
OG0004764	1	0	1	0	2	1	5
OG0004765	2	0	1	1	0	1	5
OG0004766	1	0	1	1	1	1	5
OG0004767	1	1	1	1	1	0	5
OG0004768	1	1	1	1	0	1	5
OG0004769	2	0	1	1	1	0	5
OG0004770	1	0	1	1	1	1	5
OG0004771	1	1	0	1	1	1	5
OG0004772	2	1	0	0	1	1	5
OG0004773	2	0	1	1	0	1	5
OG0004774	1	2	1	0	0	1	5
OG0004775	1	1	1	1	0	1	5
OG0004776	1	0	1	1	1	1	5
OG0004777	2	0	1	1	1	0	5
OG0004778	1	0	1	1	1	1	5
OG0004779	1	1	1	1	1	0	5
OG0004780	2	1	0	1	1	0	5
OG0004781	3	0	1	1	0	0	5
OG0004782	2	0	1	0	1	1	5
OG0004783	1	0	0	0	0	4	5
OG0004784	1	1	1	0	1	1	5
OG0004785	2	0	1	1	0	1	5
OG0004786	1	0	1	1	1	1	5
OG0004787	1	1	1	1	1	0	5
OG0004788	1	0	1	1	1	1	5
OG0004789	2	0	1	1	1	0	5
OG0004790	1	2	1	0	1	0	5
OG0004791	1	0	1	1	0	2	5
OG0004792	1	0	1	1	1	1	5
OG0004793	1	0	1	1	1	1	5
OG0004794	3	0	1	0	0	1	5
OG0004795	1	1	1	1	0	1	5
OG0004796	1	1	1	1	1	0	5
OG0004797	1	0	1	1	1	1	5
OG0004798	1	1	1	1	1	0	5
OG0004799	1	1	1	1	0	1	5
OG0004800	1	0	2	0	1	1	5
OG0004801	1	0	1	0	1	2	5
OG0004802	1	0	1	1	1	1	5
OG0004803	1	1	0	1	1	1	5
OG0004804	1	1	1	0	1	1	5
OG0004805	1	0	1	1	1	1	5
OG0004806	2	1	1	1	0	0	5
OG0004807	1	1	1	0	1	1	5
OG0004808	1	0	1	0	1	2	5
OG0004809	1	1	1	1	1	0	5
OG0004810	1	0	1	2	1	0	5
OG0004811	2	0	1	0	1	1	5
OG0004812	1	1	1	0	1	1	5
OG0004813	1	0	1	1	1	1	5
OG0004814	1	0	1	1	1	1	5
OG0004815	2	0	1	0	1	1	5
OG0004816	1	0	1	1	1	1	5
OG0004817	1	0	1	1	1	1	5
OG0004818	1	1	1	1	1	0	5
OG0004819	1	1	1	1	0	1	5
OG0004820	1	3	1	0	0	0	5
OG0004821	1	1	1	1	1	0	5
OG0004822	1	0	1	1	1	1	5
OG0004823	1	0	1	1	1	1	5
OG0004824	2	0	1	1	1	0	5
OG0004825	1	1	1	0	1	1	5
OG0004826	1	1	2	1	0	0	5
OG0004827	2	0	1	1	0	1	5
OG0004828	1	0	1	1	1	1	5
OG0004829	2	0	1	1	1	0	5
OG0004830	1	0	1	0	2	1	5
OG0004831	1	0	1	1	1	1	5
OG0004832	1	0	1	1	0	2	5
OG0004833	1	0	1	1	1	1	5
OG0004834	1	0	1	1	1	1	5
OG0004835	1	1	1	1	0	1	5
OG0004836	1	1	1	1	0	1	5
OG0004837	1	1	1	1	0	1	5
OG0004838	1	0	1	1	1	1	5
OG0004839	1	1	1	1	1	0	5
OG0004840	1	0	1	1	1	1	5
OG0004841	1	0	1	1	1	1	5
OG0004842	1	1	1	1	1	0	5
OG0004843	1	0	1	1	2	0	5
OG0004844	1	0	1	0	1	2	5
OG0004845	1	1	1	1	1	0	5
OG0004846	2	0	1	1	1	0	5
OG0004847	1	0	1	1	1	1	5
OG0004848	1	1	1	0	1	1	5
OG0004849	1	0	1	2	0	1	5
OG0004850	1	1	1	1	1	0	5
OG0004851	1	0	1	0	2	1	5
OG0004852	2	0	1	1	1	0	5
OG0004853	2	0	1	1	1	0	5
OG0004854	1	1	1	0	1	1	5
OG0004855	1	1	1	0	1	1	5
OG0004856	1	0	1	1	1	1	5
OG0004857	2	0	2	0	1	0	5
OG0004858	1	1	1	0	1	1	5
OG0004859	2	0	1	0	1	1	5
OG0004860	1	1	1	1	1	0	5
OG0004861	1	0	1	1	2	0	5
OG0004862	1	0	1	1	1	1	5
OG0004863	3	0	1	1	0	0	5
OG0004864	1	1	1	0	1	1	5
OG0004865	1	1	1	1	1	0	5
OG0004866	1	0	1	1	1	1	5
OG0004867	1	0	1	1	0	2	5
OG0004868	1	2	1	1	0	0	5
OG0004869	3	0	1	0	0	1	5
OG0004870	1	0	1	1	1	1	5
OG0004871	1	0	1	1	1	1	5
OG0004872	1	0	1	1	1	1	5
OG0004873	1	0	1	1	0	2	5
OG0004874	1	3	1	0	0	0	5
OG0004875	1	1	1	1	1	0	5
OG0004876	1	1	1	0	1	1	5
OG0004877	1	0	1	1	1	1	5
OG0004878	1	1	1	1	0	1	5
OG0004879	2	0	0	1	1	1	5
OG0004880	1	0	1	2	0	1	5
OG0004881	1	1	1	0	1	1	5
OG0004882	2	0	1	0	1	1	5
OG0004883	1	0	1	1	1	1	5
OG0004884	2	1	1	1	0	0	5
OG0004885	1	0	1	1	1	1	5
OG0004886	3	1	1	0	0	0	5
OG0004887	2	1	1	1	0	0	5
OG0004888	2	1	1	1	0	0	5
OG0004889	1	2	1	0	1	0	5
OG0004890	1	1	1	1	1	0	5
OG0004891	2	0	1	1	1	0	5
OG0004892	1	1	1	1	1	0	5
OG0004893	1	2	1	0	1	0	5
OG0004894	2	0	1	1	1	0	5
OG0004895	3	0	0	0	2	0	5
OG0004896	1	0	1	1	1	1	5
OG0004897	1	1	0	1	1	1	5
OG0004898	1	1	1	1	0	1	5
OG0004899	1	1	1	0	1	1	5
OG0004900	1	0	1	0	1	2	5
OG0004901	1	1	1	1	0	1	5
OG0004902	1	1	1	1	1	0	5
OG0004903	1	1	1	1	1	0	5
OG0004904	2	1	1	0	1	0	5
OG0004905	1	0	1	1	1	1	5
OG0004906	1	1	1	2	0	0	5
OG0004907	1	0	1	1	1	1	5
OG0004908	1	1	1	1	0	1	5
OG0004909	1	0	1	1	1	1	5
OG0004910	1	1	1	1	1	0	5
OG0004911	1	0	1	0	1	2	5
OG0004912	1	1	1	1	1	0	5
OG0004913	1	2	1	1	0	0	5
OG0004914	2	0	1	0	1	1	5
OG0004915	2	0	1	0	1	1	5
OG0004916	2	0	1	0	1	1	5
OG0004917	1	0	1	1	1	1	5
OG0004918	1	1	1	1	0	1	5
OG0004919	1	1	1	1	0	1	5
OG0004920	1	0	1	1	1	1	5
OG0004921	1	0	1	1	1	1	5
OG0004922	1	0	1	0	3	0	5
OG0004923	2	1	2	0	0	0	5
OG0004924	1	0	1	3	0	0	5
OG0004925	1	1	1	1	0	1	5
OG0004926	2	0	1	1	1	0	5
OG0004927	1	0	0	1	2	1	5
OG0004928	2	0	1	0	1	1	5
OG0004929	1	0	1	1	1	1	5
OG0004930	1	1	1	1	1	0	5
OG0004931	2	0	1	1	0	1	5
OG0004932	1	0	1	1	1	1	5
OG0004933	1	1	1	1	1	0	5
OG0004934	2	1	1	0	0	1	5
OG0004935	1	1	1	1	0	1	5
OG0004936	1	0	1	1	1	1	5
OG0004937	2	0	1	1	0	1	5
OG0004938	1	1	1	1	1	0	5
OG0004939	2	0	1	1	0	1	5
OG0004940	3	0	1	0	1	0	5
OG0004941	1	0	1	1	1	1	5
OG0004942	1	1	1	1	1	0	5
OG0004943	2	0	1	1	0	1	5
OG0004944	1	0	1	1	1	1	5
OG0004945	1	0	1	2	1	0	5
OG0004946	2	0	1	1	1	0	5
OG0004947	1	0	1	1	1	1	5
OG0004948	1	0	1	2	0	1	5
OG0004949	1	1	1	1	0	1	5
OG0004950	1	0	1	1	0	2	5
OG0004951	1	0	1	1	1	1	5
OG0004952	1	1	1	0	1	1	5
OG0004953	1	2	1	0	0	1	5
OG0004954	1	1	1	0	1	1	5
OG0004955	2	0	1	1	0	1	5
OG0004956	1	0	1	1	1	1	5
OG0004957	1	0	1	1	2	0	5
OG0004958	1	1	1	0	1	1	5
OG0004959	1	1	1	0	1	1	5
OG0004960	1	1	1	0	1	1	5
OG0004961	2	0	1	1	1	0	5
OG0004962	1	2	1	1	0	0	5
OG0004963	2	0	1	1	0	1	5
OG0004964	1	1	1	1	1	0	5
OG0004965	1	0	1	0	2	1	5
OG0004966	1	0	1	1	1	1	5
OG0004967	1	0	1	1	1	1	5
OG0004968	1	1	1	1	1	0	5
OG0004969	1	1	1	0	1	1	5
OG0004970	1	1	1	0	1	1	5
OG0004971	1	0	1	1	1	1	5
OG0004972	1	0	1	1	1	1	5
OG0004973	1	1	0	1	1	1	5
OG0004974	1	1	1	1	1	0	5
OG0004975	3	1	1	0	0	0	5
OG0004976	1	1	1	0	1	1	5
OG0004977	1	1	1	0	1	1	5
OG0004978	1	0	1	1	1	1	5
OG0004979	1	1	1	0	1	1	5
OG0004980	1	1	1	0	1	1	5
OG0004981	1	1	1	1	1	0	5
OG0004982	1	0	1	1	1	1	5
OG0004983	1	0	1	1	1	1	5
OG0004984	1	0	1	2	1	0	5
OG0004985	1	0	1	1	1	1	5
OG0004986	1	1	1	1	0	1	5
OG0004987	2	0	1	1	0	1	5
OG0004988	1	0	1	1	1	1	5
OG0004989	1	0	1	1	1	1	5
OG0004990	1	1	1	1	0	1	5
OG0004991	1	0	1	1	1	1	5
OG0004992	1	0	1	1	1	1	5
OG0004993	2	0	1	1	1	0	5
OG0004994	1	1	1	1	1	0	5
OG0004995	1	2	1	1	0	0	5
OG0004996	1	0	2	1	0	1	5
OG0004997	1	4	0	0	0	0	5
OG0004998	2	0	1	1	1	0	5
OG0004999	1	0	1	2	1	0	5
OG0005000	1	1	1	1	1	0	5
OG0005001	1	1	1	1	1	0	5
OG0005002	2	0	1	0	1	1	5
OG0005003	1	1	1	1	1	0	5
OG0005004	1	0	1	1	1	1	5
OG0005005	2	0	1	0	1	1	5
OG0005006	1	0	1	1	1	1	5
OG0005007	2	1	1	0	0	1	5
OG0005008	2	1	1	0	1	0	5
OG0005009	1	0	2	1	1	0	5
OG0005010	2	1	0	0	1	1	5
OG0005011	3	1	0	1	0	0	5
OG0005012	5	0	0	0	0	0	5
OG0005013	1	1	1	1	1	0	5
OG0005014	1	0	1	1	1	1	5
OG0005015	5	0	0	0	0	0	5
OG0005016	1	0	2	1	1	0	5
OG0005017	4	1	0	0	0	0	5
OG0005018	3	0	1	0	0	1	5
OG0005019	1	0	1	1	1	1	5
OG0005020	1	1	1	1	1	0	5
OG0005021	1	0	1	2	0	1	5
OG0005022	1	0	1	1	1	1	5
OG0005023	1	1	1	0	1	1	5
OG0005024	1	0	1	1	1	1	5
OG0005025	1	0	1	1	1	1	5
OG0005026	1	0	1	1	1	1	5
OG0005027	1	1	1	1	0	1	5
OG0005028	1	1	1	1	1	0	5
OG0005029	1	1	1	1	0	1	5
OG0005030	1	1	1	0	1	1	5
OG0005031	1	0	1	0	1	2	5
OG0005032	1	0	1	1	1	1	5
OG0005033	1	0	1	2	0	1	5
OG0005034	1	1	1	1	0	1	5
OG0005035	1	1	1	0	1	1	5
OG0005036	2	1	1	0	0	1	5
OG0005037	1	1	1	0	1	1	5
OG0005038	1	0	1	1	1	1	5
OG0005039	2	0	1	1	0	1	5
OG0005040	1	1	1	1	0	1	5
OG0005041	1	1	1	0	1	1	5
OG0005042	1	1	1	0	1	1	5
OG0005043	1	1	1	0	1	1	5
OG0005044	1	0	1	2	1	0	5
OG0005045	1	1	1	1	1	0	5
OG0005046	2	1	1	0	0	1	5
OG0005047	1	1	1	0	2	0	5
OG0005048	1	1	1	0	1	1	5
OG0005049	1	0	1	0	2	1	5
OG0005050	1	0	0	1	1	2	5
OG0005051	2	0	1	1	1	0	5
OG0005052	1	0	0	2	1	1	5
OG0005053	1	1	1	1	0	1	5
OG0005054	1	1	1	1	0	1	5
OG0005055	1	0	1	1	1	1	5
OG0005056	1	1	1	0	0	2	5
OG0005057	1	1	1	1	0	1	5
OG0005058	1	2	1	1	0	0	5
OG0005059	1	1	1	1	0	1	5
OG0005060	1	1	1	1	1	0	5
OG0005061	2	0	2	0	0	1	5
OG0005062	1	0	1	1	1	1	5
OG0005063	1	1	1	1	0	1	5
OG0005064	1	0	1	2	1	0	5
OG0005065	1	1	1	1	0	1	5
OG0005066	1	0	1	1	1	1	5
OG0005067	1	0	1	1	1	1	5
OG0005068	1	1	0	1	1	1	5
OG0005069	1	0	1	1	1	1	5
OG0005070	1	0	1	2	0	1	5
OG0005071	1	0	1	1	1	1	5
OG0005072	1	0	1	2	1	0	5
OG0005073	1	0	1	1	0	2	5
OG0005074	1	0	1	1	1	1	5
OG0005075	2	3	0	0	0	0	5
OG0005076	3	2	0	0	0	0	5
OG0005077	2	0	1	1	0	1	5
OG0005078	3	0	0	0	1	1	5
OG0005079	1	0	1	1	1	1	5
OG0005080	1	0	1	1	1	1	5
OG0005081	2	0	1	2	0	0	5
OG0005082	1	1	1	1	1	0	5
OG0005083	1	1	1	1	0	1	5
OG0005084	1	1	1	0	1	1	5
OG0005085	1	1	1	0	1	1	5
OG0005086	1	1	1	1	0	1	5
OG0005087	1	2	1	0	1	0	5
OG0005088	1	0	1	1	1	1	5
OG0005089	1	1	1	1	0	1	5
OG0005090	1	0	1	1	1	1	5
OG0005091	1	0	1	0	1	2	5
OG0005092	1	1	1	0	1	1	5
OG0005093	1	0	1	2	0	1	5
OG0005094	1	1	1	0	0	2	5
OG0005095	1	0	1	1	2	0	5
OG0005096	1	0	1	1	1	1	5
OG0005097	1	1	1	1	0	1	5
OG0005098	1	0	1	1	1	1	5
OG0005099	1	0	1	1	1	1	5
OG0005100	1	1	0	1	1	1	5
OG0005101	1	1	1	1	0	1	5
OG0005102	1	0	1	1	1	1	5
OG0005103	1	1	1	1	0	1	5
OG0005104	1	0	1	1	1	1	5
OG0005105	1	1	1	1	1	0	5
OG0005106	1	1	1	0	1	1	5
OG0005107	1	1	1	0	1	1	5
OG0005108	1	0	1	1	1	1	5
OG0005109	1	1	1	1	1	0	5
OG0005110	1	0	1	1	1	1	5
OG0005111	1	1	1	1	1	0	5
OG0005112	1	0	2	1	1	0	5
OG0005113	1	0	1	1	1	1	5
OG0005114	1	1	1	1	1	0	5
OG0005115	1	1	1	0	1	1	5
OG0005116	2	0	1	1	1	0	5
OG0005117	1	0	1	1	1	1	5
OG0005118	2	0	1	1	1	0	5
OG0005119	5	0	0	0	0	0	5
OG0005120	1	1	1	1	0	1	5
OG0005121	1	1	1	1	1	0	5
OG0005122	3	0	0	1	0	1	5
OG0005123	2	0	1	0	1	1	5
OG0005124	1	1	1	0	1	1	5
OG0005125	1	1	1	1	0	1	5
OG0005126	1	1	2	1	0	0	5
OG0005127	1	1	1	0	1	1	5
OG0005128	1	0	1	1	1	1	5
OG0005129	1	0	1	0	2	1	5
OG0005130	1	2	1	0	1	0	5
OG0005131	3	1	1	0	0	0	5
OG0005132	2	0	1	1	1	0	5
OG0005133	1	1	1	1	1	0	5
OG0005134	1	1	1	1	1	0	5
OG0005135	1	1	1	1	1	0	5
OG0005136	1	0	0	1	1	2	5
OG0005137	1	0	1	1	1	1	5
OG0005138	2	0	1	0	1	1	5
OG0005139	1	0	1	1	1	1	5
OG0005140	2	0	1	1	1	0	5
OG0005141	1	0	1	1	2	0	5
OG0005142	1	1	1	1	1	0	5
OG0005143	1	1	1	1	0	1	5
OG0005144	1	1	1	1	0	1	5
OG0005145	1	1	1	1	0	1	5
OG0005146	1	0	1	1	1	1	5
OG0005147	1	1	1	0	1	1	5
OG0005148	1	1	1	1	0	1	5
OG0005149	1	1	1	0	1	1	5
OG0005150	1	1	1	1	1	0	5
OG0005151	1	1	1	0	1	1	5
OG0005152	1	1	1	1	1	0	5
OG0005153	1	0	2	0	1	1	5
OG0005154	1	0	1	2	0	1	5
OG0005155	1	1	1	0	1	1	5
OG0005156	1	1	1	1	0	1	5
OG0005157	2	0	0	1	1	1	5
OG0005158	1	1	1	1	0	1	5
OG0005159	1	0	1	0	2	1	5
OG0005160	1	1	1	0	1	1	5
OG0005161	1	0	1	0	1	2	5
OG0005162	2	1	1	0	1	0	5
OG0005163	1	0	1	2	1	0	5
OG0005164	1	1	1	1	0	1	5
OG0005165	2	1	0	1	0	1	5
OG0005166	2	0	1	0	1	1	5
OG0005167	1	0	1	1	1	1	5
OG0005168	1	0	1	2	1	0	5
OG0005169	1	1	1	1	1	0	5
OG0005170	1	0	1	0	2	1	5
OG0005171	1	1	1	0	1	1	5
OG0005172	1	0	1	1	1	1	5
OG0005173	3	0	1	0	1	0	5
OG0005174	2	1	2	0	0	0	5
OG0005175	1	2	1	0	1	0	5
OG0005176	1	0	1	1	1	1	5
OG0005177	1	1	0	1	1	1	5
OG0005178	1	0	2	0	1	1	5
OG0005179	1	0	1	1	1	1	5
OG0005180	1	1	1	1	1	0	5
OG0005181	1	2	1	0	1	0	5
OG0005182	1	1	1	1	1	0	5
OG0005183	2	1	1	1	0	0	5
OG0005184	1	1	1	1	1	0	5
OG0005185	1	0	1	0	1	2	5
OG0005186	1	1	1	0	1	1	5
OG0005187	1	2	1	0	0	1	5
OG0005188	3	0	1	1	0	0	5
OG0005189	1	1	1	1	1	0	5
OG0005190	2	0	1	1	0	1	5
OG0005191	1	0	2	0	1	1	5
OG0005192	1	2	1	0	1	0	5
OG0005193	1	1	1	1	0	1	5
OG0005194	1	1	1	0	1	1	5
OG0005195	1	1	1	0	1	1	5
OG0005196	1	0	1	1	1	1	5
OG0005197	1	0	1	1	1	1	5
OG0005198	1	1	1	1	0	1	5
OG0005199	1	1	1	1	1	0	5
OG0005200	5	0	0	0	0	0	5
OG0005201	3	0	1	0	0	1	5
OG0005202	1	0	1	1	1	1	5
OG0005203	1	0	1	1	1	1	5
OG0005204	1	0	2	0	0	2	5
OG0005205	1	1	1	0	1	1	5
OG0005206	1	1	1	1	1	0	5
OG0005207	2	0	1	0	1	1	5
OG0005208	1	1	1	1	1	0	5
OG0005209	1	1	1	0	1	1	5
OG0005210	2	0	1	0	1	1	5
OG0005211	1	1	1	0	1	1	5
OG0005212	1	1	1	0	1	1	5
OG0005213	1	1	1	1	0	1	5
OG0005214	1	1	1	0	2	0	5
OG0005215	1	2	0	1	0	1	5
OG0005216	1	1	1	1	0	1	5
OG0005217	1	0	1	2	0	1	5
OG0005218	1	2	1	0	1	0	5
OG0005219	1	0	1	1	1	1	5
OG0005220	1	1	1	0	1	1	5
OG0005221	1	1	1	0	1	1	5
OG0005222	1	1	1	0	1	1	5
OG0005223	1	1	1	0	1	1	5
OG0005224	1	0	1	1	1	1	5
OG0005225	1	0	1	1	1	1	5
OG0005226	1	0	1	1	1	1	5
OG0005227	1	0	1	2	1	0	5
OG0005228	1	1	1	0	1	1	5
OG0005229	1	1	1	1	0	1	5
OG0005230	1	1	1	1	0	1	5
OG0005231	1	1	1	0	1	1	5
OG0005232	1	1	1	0	2	0	5
OG0005233	1	0	1	1	0	2	5
OG0005234	1	1	1	0	1	1	5
OG0005235	1	1	1	0	1	1	5
OG0005236	1	1	1	1	1	0	5
OG0005237	1	0	1	1	0	2	5
OG0005238	2	0	3	0	0	0	5
OG0005239	1	0	1	2	0	1	5
OG0005240	1	1	1	0	1	1	5
OG0005241	1	0	1	1	1	1	5
OG0005242	1	0	1	1	1	1	5
OG0005243	2	1	1	1	0	0	5
OG0005244	2	1	1	0	0	1	5
OG0005245	1	1	1	0	1	1	5
OG0005246	1	1	1	1	1	0	5
OG0005247	1	1	1	2	0	0	5
OG0005248	1	0	1	1	1	1	5
OG0005249	1	0	1	1	1	1	5
OG0005250	1	0	1	1	1	1	5
OG0005251	2	0	1	0	1	1	5
OG0005252	1	0	1	1	1	1	5
OG0005253	2	0	1	1	1	0	5
OG0005254	1	0	1	1	1	1	5
OG0005255	1	1	1	0	1	1	5
OG0005256	1	0	1	1	1	1	5
OG0005257	1	0	1	1	1	1	5
OG0005258	1	1	1	1	1	0	5
OG0005259	1	1	1	0	1	1	5
OG0005260	1	1	1	1	1	0	5
OG0005261	1	1	0	1	1	1	5
OG0005262	1	0	1	1	1	1	5
OG0005263	1	0	1	1	1	1	5
OG0005264	2	2	1	0	0	0	5
OG0005265	1	0	1	1	1	1	5
OG0005266	1	1	1	1	0	1	5
OG0005267	1	1	1	0	1	1	5
OG0005268	2	1	1	0	0	1	5
OG0005269	2	1	1	0	0	1	5
OG0005270	1	0	1	1	1	1	5
OG0005271	1	1	1	1	0	1	5
OG0005272	1	2	1	0	1	0	5
OG0005273	1	0	1	1	1	1	5
OG0005274	1	0	1	0	1	2	5
OG0005275	2	0	1	1	1	0	5
OG0005276	1	1	1	1	1	0	5
OG0005277	1	0	1	1	1	1	5
OG0005278	1	0	1	1	1	1	5
OG0005279	1	1	1	0	1	1	5
OG0005280	2	0	1	1	0	1	5
OG0005281	1	0	1	1	1	1	5
OG0005282	1	0	1	1	1	1	5
OG0005283	1	1	1	0	2	0	5
OG0005284	1	0	1	1	1	1	5
OG0005285	1	0	1	2	0	1	5
OG0005286	1	1	1	0	1	1	5
OG0005287	1	1	1	1	0	1	5
OG0005288	2	1	1	1	0	0	5
OG0005289	2	0	1	0	0	2	5
OG0005290	2	0	1	1	0	1	5
OG0005291	1	0	1	1	1	1	5
OG0005292	1	1	1	0	1	1	5
OG0005293	1	0	1	1	1	1	5
OG0005294	1	1	1	0	1	1	5
OG0005295	1	1	1	0	1	1	5
OG0005296	1	0	1	2	0	1	5
OG0005297	1	1	1	1	0	1	5
OG0005298	2	1	1	0	0	1	5
OG0005299	2	0	1	0	1	1	5
OG0005300	1	1	1	1	1	0	5
OG0005301	1	0	1	1	1	1	5
OG0005302	1	1	1	1	1	0	5
OG0005303	1	0	1	1	2	0	5
OG0005304	1	0	0	2	1	1	5
OG0005305	1	0	1	0	1	2	5
OG0005306	1	0	1	1	1	1	5
OG0005307	3	1	1	0	0	0	5
OG0005308	1	1	1	1	0	1	5
OG0005309	1	0	1	1	1	1	5
OG0005310	1	2	1	1	0	0	5
OG0005311	1	0	1	1	1	1	5
OG0005312	1	1	1	0	1	1	5
OG0005313	1	0	1	1	1	1	5
OG0005314	1	0	1	1	1	1	5
OG0005315	1	0	1	1	1	1	5
OG0005316	1	1	1	0	1	1	5
OG0005317	1	1	1	0	0	2	5
OG0005318	1	1	1	1	1	0	5
OG0005319	1	0	1	2	0	1	5
OG0005320	1	1	1	1	0	1	5
OG0005321	2	0	1	1	1	0	5
OG0005322	1	0	1	0	2	1	5
OG0005323	2	0	1	1	0	1	5
OG0005324	1	1	1	1	1	0	5
OG0005325	1	1	1	1	0	1	5
OG0005326	1	0	1	1	1	1	5
OG0005327	1	0	1	1	1	1	5
OG0005328	2	1	1	0	1	0	5
OG0005329	1	1	1	1	0	1	5
OG0005330	1	0	1	2	1	0	5
OG0005331	1	2	1	1	0	0	5
OG0005332	1	1	1	1	0	1	5
OG0005333	1	1	1	1	1	0	5
OG0005334	1	0	1	1	1	1	5
OG0005335	1	0	1	1	1	1	5
OG0005336	1	0	1	2	1	0	5
OG0005337	1	0	1	1	1	1	5
OG0005338	1	0	1	1	1	1	5
OG0005339	1	0	1	1	1	1	5
OG0005340	1	0	2	0	0	2	5
OG0005341	1	1	1	0	1	1	5
OG0005342	1	0	1	2	1	0	5
OG0005343	1	0	1	1	1	1	5
OG0005344	1	1	0	0	2	1	5
OG0005345	2	0	1	1	0	1	5
OG0005346	1	0	1	1	1	1	5
OG0005347	1	1	1	0	1	1	5
OG0005348	2	0	1	0	1	1	5
OG0005349	1	1	1	1	0	1	5
OG0005350	1	0	1	1	1	1	5
OG0005351	1	1	1	0	1	1	5
OG0005352	1	0	1	1	1	1	5
OG0005353	2	0	1	1	1	0	5
OG0005354	1	0	1	1	1	1	5
OG0005355	1	2	1	1	0	0	5
OG0005356	2	1	1	0	1	0	5
OG0005357	1	1	1	0	1	1	5
OG0005358	1	0	1	0	2	1	5
OG0005359	1	0	1	2	0	1	5
OG0005360	1	1	1	1	1	0	5
OG0005361	1	2	0	0	1	1	5
OG0005362	1	2	1	0	1	0	5
OG0005363	1	1	0	1	1	1	5
OG0005364	1	0	1	1	1	1	5
OG0005365	1	2	0	1	1	0	5
OG0005366	1	1	1	0	1	1	5
OG0005367	1	0	1	1	1	1	5
OG0005368	1	1	1	1	1	0	5
OG0005369	1	0	1	0	1	2	5
OG0005370	1	1	1	0	1	1	5
OG0005371	1	1	1	1	1	0	5
OG0005372	1	2	1	1	0	0	5
OG0005373	2	0	1	0	1	1	5
OG0005374	1	1	1	1	0	1	5
OG0005375	1	1	1	1	1	0	5
OG0005376	1	1	1	0	1	1	5
OG0005377	1	1	1	0	1	1	5
OG0005378	2	0	1	0	1	1	5
OG0005379	1	0	1	1	1	1	5
OG0005380	1	0	1	1	0	2	5
OG0005381	1	1	1	1	1	0	5
OG0005382	1	1	1	0	1	1	5
OG0005383	1	0	1	1	1	1	5
OG0005384	1	0	1	1	1	1	5
OG0005385	1	0	1	1	1	1	5
OG0005386	1	1	0	2	1	0	5
OG0005387	1	0	1	2	1	0	5
OG0005388	1	1	1	1	1	0	5
OG0005389	1	1	1	0	1	1	5
OG0005390	1	1	1	0	1	1	5
OG0005391	1	1	1	0	1	1	5
OG0005392	2	0	1	1	1	0	5
OG0005393	1	0	1	2	1	0	5
OG0005394	1	1	1	1	1	0	5
OG0005395	1	1	1	1	0	1	5
OG0005396	1	1	1	1	0	1	5
OG0005397	1	1	1	1	0	1	5
OG0005398	1	0	4	0	0	0	5
OG0005399	1	1	1	1	0	1	5
OG0005400	1	0	1	1	2	0	5
OG0005401	1	0	1	1	1	1	5
OG0005402	1	1	1	1	0	1	5
OG0005403	1	1	0	1	1	1	5
OG0005404	1	1	1	1	0	1	5
OG0005405	1	0	1	1	1	1	5
OG0005406	1	1	1	0	1	1	5
OG0005407	1	1	1	1	1	0	5
OG0005408	1	1	1	1	1	0	5
OG0005409	1	1	1	1	1	0	5
OG0005410	1	0	1	1	1	1	5
OG0005411	1	0	1	0	1	2	5
OG0005412	1	0	2	0	1	1	5
OG0005413	1	0	1	1	2	0	5
OG0005414	1	0	1	1	1	1	5
OG0005415	1	0	1	1	1	1	5
OG0005416	1	0	1	1	1	1	5
OG0005417	1	0	0	1	2	1	5
OG0005418	1	1	1	0	1	1	5
OG0005419	1	1	1	2	0	0	5
OG0005420	1	1	1	1	1	0	5
OG0005421	1	1	1	1	1	0	5
OG0005422	1	1	1	0	1	1	5
OG0005423	1	0	1	1	1	1	5
OG0005424	1	0	1	1	1	1	5
OG0005425	1	1	1	1	0	1	5
OG0005426	1	1	0	1	1	1	5
OG0005427	1	1	1	1	0	1	5
OG0005428	1	1	1	0	1	1	5
OG0005429	1	1	1	0	1	1	5
OG0005430	1	1	1	0	1	1	5
OG0005431	1	0	1	1	1	1	5
OG0005432	1	0	1	1	1	1	5
OG0005433	1	0	1	1	1	1	5
OG0005434	2	0	1	1	0	1	5
OG0005435	1	1	1	1	1	0	5
OG0005436	1	0	1	1	1	1	5
OG0005437	1	0	1	1	1	1	5
OG0005438	1	1	1	1	1	0	5
OG0005439	1	0	1	1	1	1	5
OG0005440	2	0	1	0	1	1	5
OG0005441	1	1	1	0	1	1	5
OG0005442	1	1	1	1	0	1	5
OG0005443	1	0	1	2	1	0	5
OG0005444	1	0	1	1	1	1	5
OG0005445	1	1	1	0	1	1	5
OG0005446	1	0	1	1	1	1	5
OG0005447	1	0	1	0	2	1	5
OG0005448	1	1	1	0	1	1	5
OG0005449	1	1	1	1	1	0	5
OG0005450	1	0	1	1	1	1	5
OG0005451	1	1	1	2	0	0	5
OG0005452	1	1	1	2	0	0	5
OG0005453	1	0	1	1	1	1	5
OG0005454	1	0	1	1	1	1	5
OG0005455	1	0	1	1	1	1	5
OG0005456	1	0	1	1	1	1	5
OG0005457	1	0	1	1	1	1	5
OG0005458	1	1	2	0	1	0	5
OG0005459	1	1	1	1	1	0	5
OG0005460	1	1	1	1	1	0	5
OG0005461	1	1	1	0	1	1	5
OG0005462	2	2	1	0	0	0	5
OG0005463	2	1	0	1	1	0	5
OG0005464	1	1	0	1	1	1	5
OG0005465	1	2	1	0	0	1	5
OG0005466	1	1	1	1	1	0	5
OG0005467	2	1	1	1	0	0	5
OG0005468	1	0	1	1	1	1	5
OG0005469	1	1	1	1	0	1	5
OG0005470	1	1	1	0	1	1	5
OG0005471	1	0	1	0	2	1	5
OG0005472	1	1	0	1	0	2	5
OG0005473	1	0	1	1	1	1	5
OG0005474	1	1	1	1	1	0	5
OG0005475	1	0	1	1	1	1	5
OG0005476	1	1	1	0	1	1	5
OG0005477	1	1	1	0	1	1	5
OG0005478	1	0	1	1	1	1	5
OG0005479	1	1	1	1	0	1	5
OG0005480	1	1	1	1	0	1	5
OG0005481	1	1	1	1	0	1	5
OG0005482	1	1	1	1	0	1	5
OG0005483	1	0	1	1	1	1	5
OG0005484	1	0	1	1	1	1	5
OG0005485	1	0	1	1	1	1	5
OG0005486	1	0	1	1	1	1	5
OG0005487	1	1	1	1	0	1	5
OG0005488	1	1	1	1	1	0	5
OG0005489	1	0	1	1	1	1	5
OG0005490	1	0	1	0	1	2	5
OG0005491	1	1	1	0	1	1	5
OG0005492	1	1	1	1	0	1	5
OG0005493	1	0	0	2	1	1	5
OG0005494	1	0	1	1	1	1	5
OG0005495	1	0	1	1	2	0	5
OG0005496	1	0	1	1	1	1	5
OG0005497	1	1	1	1	1	0	5
OG0005498	1	1	1	0	1	1	5
OG0005499	1	2	1	0	0	1	5
OG0005500	1	0	1	1	2	0	5
OG0005501	1	2	1	0	1	0	5
OG0005502	1	0	1	1	1	1	5
OG0005503	1	1	1	0	1	1	5
OG0005504	1	1	1	1	1	0	5
OG0005505	1	0	1	1	1	1	5
OG0005506	1	0	1	1	1	1	5
OG0005507	1	1	1	1	0	1	5
OG0005508	1	1	0	2	1	0	5
OG0005509	1	1	1	1	1	0	5
OG0005510	1	0	1	2	1	0	5
OG0005511	1	1	1	0	1	1	5
OG0005512	2	1	1	0	0	1	5
OG0005513	1	0	1	0	1	2	5
OG0005514	1	2	1	1	0	0	5
OG0005515	2	0	1	1	0	1	5
OG0005516	1	1	1	1	1	0	5
OG0005517	1	1	1	1	0	1	5
OG0005518	1	1	1	0	1	1	5
OG0005519	1	1	1	1	1	0	5
OG0005520	1	1	1	0	1	1	5
OG0005521	1	2	1	0	0	1	5
OG0005522	1	1	1	1	1	0	5
OG0005523	1	0	1	1	1	1	5
OG0005524	1	1	0	1	0	2	5
OG0005525	1	1	1	0	1	1	5
OG0005526	1	0	1	1	2	0	5
OG0005527	1	1	1	0	1	1	5
OG0005528	1	1	1	1	0	1	5
OG0005529	1	1	1	0	1	1	5
OG0005530	2	0	1	0	0	2	5
OG0005531	1	1	1	1	1	0	5
OG0005532	1	0	1	1	1	1	5
OG0005533	1	0	1	1	1	1	5
OG0005534	1	2	1	1	0	0	5
OG0005535	1	0	1	1	1	1	5
OG0005536	1	2	1	1	0	0	5
OG0005537	1	0	0	1	2	1	5
OG0005538	2	0	1	0	2	0	5
OG0005539	2	1	1	0	1	0	5
OG0005540	1	0	1	1	1	1	5
OG0005541	1	0	1	1	1	1	5
OG0005542	2	0	1	1	0	1	5
OG0005543	1	0	1	0	2	1	5
OG0005544	1	0	1	1	2	0	5
OG0005545	1	0	1	1	1	1	5
OG0005546	1	1	1	1	0	1	5
OG0005547	1	0	1	1	1	1	5
OG0005548	1	1	1	1	0	1	5
OG0005549	1	0	1	1	0	2	5
OG0005550	1	1	1	1	1	0	5
OG0005551	1	0	1	1	2	0	5
OG0005552	1	1	1	1	1	0	5
OG0005553	1	0	1	1	1	1	5
OG0005554	1	1	1	1	1	0	5
OG0005555	1	2	1	1	0	0	5
OG0005556	1	0	1	1	1	1	5
OG0005557	1	1	1	1	1	0	5
OG0005558	1	0	1	1	1	1	5
OG0005559	1	1	1	0	1	1	5
OG0005560	2	1	1	0	1	0	5
OG0005561	1	0	1	1	1	1	5
OG0005562	1	0	1	0	1	2	5
OG0005563	1	0	1	1	1	1	5
OG0005564	1	0	1	1	1	1	5
OG0005565	1	0	1	1	1	1	5
OG0005566	1	0	1	1	1	1	5
OG0005567	1	0	1	0	1	2	5
OG0005568	1	0	1	1	1	1	5
OG0005569	1	1	1	0	1	1	5
OG0005570	1	1	1	1	0	1	5
OG0005571	1	1	1	1	0	1	5
OG0005572	1	2	1	1	0	0	5
OG0005573	1	1	1	1	1	0	5
OG0005574	1	1	1	1	1	0	5
OG0005575	1	0	1	2	0	1	5
OG0005576	1	1	0	1	1	1	5
OG0005577	1	0	1	2	1	0	5
OG0005578	1	0	1	1	1	1	5
OG0005579	2	0	1	1	1	0	5
OG0005580	1	1	1	1	1	0	5
OG0005581	1	1	1	1	1	0	5
OG0005582	1	0	1	1	1	1	5
OG0005583	1	1	1	1	1	0	5
OG0005584	2	1	1	0	0	1	5
OG0005585	1	0	1	1	0	2	5
OG0005586	1	1	1	1	1	0	5
OG0005587	1	0	1	1	1	1	5
OG0005588	1	1	1	2	0	0	5
OG0005589	1	0	1	0	2	1	5
OG0005590	1	1	1	1	1	0	5
OG0005591	1	0	1	1	1	1	5
OG0005592	1	0	1	1	1	1	5
OG0005593	1	1	0	1	1	1	5
OG0005594	1	0	0	1	0	3	5
OG0005595	1	4	0	0	0	0	5
OG0005596	1	2	1	0	1	0	5
OG0005597	1	1	1	2	0	0	5
OG0005598	1	1	1	1	0	1	5
OG0005599	1	1	1	1	1	0	5
OG0005600	1	1	1	0	1	1	5
OG0005601	1	0	1	1	1	1	5
OG0005602	1	1	1	1	0	1	5
OG0005603	1	1	1	1	0	1	5
OG0005604	1	0	1	1	1	1	5
OG0005605	1	1	1	0	1	1	5
OG0005606	1	0	1	1	1	1	5
OG0005607	1	1	1	1	1	0	5
OG0005608	1	1	1	1	1	0	5
OG0005609	2	0	1	0	1	1	5
OG0005610	1	1	1	0	1	1	5
OG0005611	2	0	1	0	2	0	5
OG0005612	2	0	1	1	1	0	5
OG0005613	1	1	1	1	0	1	5
OG0005614	1	0	1	1	1	1	5
OG0005615	1	2	1	1	0	0	5
OG0005616	1	0	1	1	1	1	5
OG0005617	1	1	1	1	1	0	5
OG0005618	1	2	1	0	1	0	5
OG0005619	1	0	1	1	1	1	5
OG0005620	2	0	1	1	1	0	5
OG0005621	3	0	1	0	1	0	5
OG0005622	1	1	1	0	1	1	5
OG0005623	1	1	1	1	0	1	5
OG0005624	1	0	1	1	1	1	5
OG0005625	1	0	1	1	1	1	5
OG0005626	1	1	1	0	0	2	5
OG0005627	1	1	1	1	1	0	5
OG0005628	1	1	1	0	1	1	5
OG0005629	1	0	1	0	1	2	5
OG0005630	1	0	1	1	1	1	5
OG0005631	1	0	1	1	1	1	5
OG0005632	1	0	1	3	0	0	5
OG0005633	1	1	1	0	2	0	5
OG0005634	1	0	1	1	1	1	5
OG0005635	1	1	1	1	1	0	5
OG0005636	1	0	1	1	2	0	5
OG0005637	1	2	1	1	0	0	5
OG0005638	1	0	1	1	1	1	5
OG0005639	1	0	1	2	1	0	5
OG0005640	2	0	1	1	1	0	5
OG0005641	1	0	1	1	1	1	5
OG0005642	1	0	1	1	1	1	5
OG0005643	2	0	1	1	1	0	5
OG0005644	1	0	1	1	1	1	5
OG0005645	1	1	1	0	1	1	5
OG0005646	1	1	1	0	1	1	5
OG0005647	1	2	1	0	1	0	5
OG0005648	2	0	2	0	0	1	5
OG0005649	1	1	1	1	0	1	5
OG0005650	1	0	1	1	0	2	5
OG0005651	2	0	1	1	0	1	5
OG0005652	1	0	1	2	1	0	5
OG0005653	1	0	2	0	1	1	5
OG0005654	1	1	0	1	2	0	5
OG0005655	1	1	2	1	0	0	5
OG0005656	1	0	1	1	1	1	5
OG0005657	1	0	1	1	1	1	5
OG0005658	2	1	0	1	1	0	5
OG0005659	1	1	1	0	1	1	5
OG0005660	1	0	1	1	1	1	5
OG0005661	1	0	1	1	1	1	5
OG0005662	1	0	1	1	1	1	5
OG0005663	1	0	2	1	0	1	5
OG0005664	1	1	1	1	1	0	5
OG0005665	1	1	1	2	0	0	5
OG0005666	1	0	1	0	2	1	5
OG0005667	1	1	1	1	1	0	5
OG0005668	1	0	1	1	2	0	5
OG0005669	1	1	1	1	1	0	5
OG0005670	1	1	0	0	1	2	5
OG0005671	2	0	1	1	1	0	5
OG0005672	1	0	1	1	1	1	5
OG0005673	1	1	1	1	0	1	5
OG0005674	1	1	1	1	1	0	5
OG0005675	1	0	1	1	1	1	5
OG0005676	1	0	1	1	1	1	5
OG0005677	1	1	1	1	1	0	5
OG0005678	1	1	1	1	1	0	5
OG0005679	1	1	1	1	1	0	5
OG0005680	1	1	0	1	1	1	5
OG0005681	1	1	1	1	1	0	5
OG0005682	1	1	1	0	1	1	5
OG0005683	1	1	1	0	1	1	5
OG0005684	1	0	1	1	0	2	5
OG0005685	1	0	1	1	1	1	5
OG0005686	1	0	1	1	1	1	5
OG0005687	1	1	1	1	1	0	5
OG0005688	1	0	1	1	1	1	5
OG0005689	1	1	1	1	1	0	5
OG0005690	1	0	1	2	1	0	5
OG0005691	1	0	1	2	1	0	5
OG0005692	1	0	1	1	1	1	5
OG0005693	1	1	1	0	1	1	5
OG0005694	1	1	1	1	0	1	5
OG0005695	1	1	1	2	0	0	5
OG0005696	2	0	1	0	1	1	5
OG0005697	1	1	1	1	1	0	5
OG0005698	1	1	1	0	1	1	5
OG0005699	1	0	1	0	2	1	5
OG0005700	1	0	1	0	1	2	5
OG0005701	1	0	1	1	1	1	5
OG0005702	1	1	1	0	0	2	5
OG0005703	1	0	1	1	1	1	5
OG0005704	1	0	1	0	2	1	5
OG0005705	1	2	1	0	0	1	5
OG0005706	1	1	1	0	1	1	5
OG0005707	1	1	1	0	1	1	5
OG0005708	2	0	1	2	0	0	5
OG0005709	1	1	1	1	1	0	5
OG0005710	1	1	1	0	1	1	5
OG0005711	1	0	0	1	0	3	5
OG0005712	1	0	1	1	1	1	5
OG0005713	1	0	1	1	1	1	5
OG0005714	1	0	1	1	1	1	5
OG0005715	1	1	1	1	0	1	5
OG0005716	1	1	1	1	1	0	5
OG0005717	1	0	1	1	2	0	5
OG0005718	1	0	1	1	2	0	5
OG0005719	1	1	1	1	1	0	5
OG0005720	1	0	1	2	1	0	5
OG0005721	1	2	1	1	0	0	5
OG0005722	1	2	1	0	0	1	5
OG0005723	1	0	1	1	1	1	5
OG0005724	1	0	2	2	0	0	5
OG0005725	1	1	1	0	1	1	5
OG0005726	1	0	1	1	1	1	5
OG0005727	1	0	2	1	1	0	5
OG0005728	1	0	1	1	0	2	5
OG0005729	1	1	1	0	1	1	5
OG0005730	2	1	1	0	0	1	5
OG0005731	1	0	1	1	1	1	5
OG0005732	1	1	1	0	1	1	5
OG0005733	1	0	1	1	1	1	5
OG0005734	1	0	1	2	1	0	5
OG0005735	1	0	0	3	1	0	5
OG0005736	1	1	1	0	1	1	5
OG0005737	1	2	1	1	0	0	5
OG0005738	1	0	1	1	1	1	5
OG0005739	1	4	0	0	0	0	5
OG0005740	1	1	1	1	0	1	5
OG0005741	1	0	1	1	1	1	5
OG0005742	1	1	1	1	1	0	5
OG0005743	1	1	1	0	1	1	5
OG0005744	1	0	1	3	0	0	5
OG0005745	1	1	1	1	1	0	5
OG0005746	1	0	1	1	1	1	5
OG0005747	1	1	1	1	1	0	5
OG0005748	1	1	1	1	0	1	5
OG0005749	1	1	1	0	1	1	5
OG0005750	1	1	1	1	0	1	5
OG0005751	1	0	1	1	1	1	5
OG0005752	1	2	1	0	1	0	5
OG0005753	1	1	1	0	1	1	5
OG0005754	1	0	1	1	1	1	5
OG0005755	1	0	1	0	2	1	5
OG0005756	1	1	1	1	0	1	5
OG0005757	1	1	1	0	1	1	5
OG0005758	2	1	1	0	1	0	5
OG0005759	1	0	1	1	1	1	5
OG0005760	1	1	1	1	0	1	5
OG0005761	1	0	1	1	1	1	5
OG0005762	1	0	1	1	1	1	5
OG0005763	1	0	1	1	1	1	5
OG0005764	1	1	1	1	1	0	5
OG0005765	1	0	1	0	1	2	5
OG0005766	1	0	1	1	0	2	5
OG0005767	1	1	1	0	1	1	5
OG0005768	1	0	1	1	1	1	5
OG0005769	1	1	1	0	1	1	5
OG0005770	1	1	1	0	1	1	5
OG0005771	1	0	0	1	1	2	5
OG0005772	1	1	1	1	1	0	5
OG0005773	1	0	1	2	0	1	5
OG0005774	1	0	1	0	1	2	5
OG0005775	1	0	1	2	1	0	5
OG0005776	1	1	1	0	1	1	5
OG0005777	1	1	1	1	0	1	5
OG0005778	1	1	1	0	1	1	5
OG0005779	2	0	1	0	1	1	5
OG0005780	1	1	1	0	1	1	5
OG0005781	1	2	0	2	0	0	5
OG0005782	1	0	0	1	2	1	5
OG0005783	1	1	1	0	1	1	5
OG0005784	1	1	1	0	1	1	5
OG0005785	1	0	1	2	0	1	5
OG0005786	1	2	0	1	1	0	5
OG0005787	1	1	1	0	1	1	5
OG0005788	1	1	1	1	1	0	5
OG0005789	1	0	1	1	1	1	5
OG0005790	1	0	1	1	1	1	5
OG0005791	1	0	1	1	1	1	5
OG0005792	1	1	1	1	0	1	5
OG0005793	1	1	0	1	1	1	5
OG0005794	1	0	1	1	1	1	5
OG0005795	1	0	1	2	0	1	5
OG0005796	1	0	1	1	1	1	5
OG0005797	1	1	1	0	2	0	5
OG0005798	1	0	1	1	1	1	5
OG0005799	1	1	1	1	1	0	5
OG0005800	1	1	1	0	1	1	5
OG0005801	1	0	1	1	1	1	5
OG0005802	1	1	1	0	1	1	5
OG0005803	1	0	1	1	1	1	5
OG0005804	1	0	1	1	1	1	5
OG0005805	1	0	1	1	1	1	5
OG0005806	1	1	1	1	0	1	5
OG0005807	1	0	2	0	1	1	5
OG0005808	1	1	1	0	1	1	5
OG0005809	1	0	1	1	1	1	5
OG0005810	1	1	1	2	0	0	5
OG0005811	1	0	1	1	1	1	5
OG0005812	1	0	1	1	1	1	5
OG0005813	1	1	1	0	1	1	5
OG0005814	1	1	1	1	1	0	5
OG0005815	1	1	1	0	1	1	5
OG0005816	1	1	1	1	1	0	5
OG0005817	1	2	1	0	1	0	5
OG0005818	1	0	1	2	0	1	5
OG0005819	1	2	1	0	0	1	5
OG0005820	1	1	1	0	1	1	5
OG0005821	1	0	1	2	1	0	5
OG0005822	1	0	1	1	1	1	5
OG0005823	1	1	2	0	0	1	5
OG0005824	1	0	1	1	1	1	5
OG0005825	1	0	1	1	1	1	5
OG0005826	1	0	1	1	1	1	5
OG0005827	1	1	1	1	1	0	5
OG0005828	1	1	1	0	1	1	5
OG0005829	1	1	1	0	1	1	5
OG0005830	1	0	2	0	1	1	5
OG0005831	1	1	1	1	1	0	5
OG0005832	1	0	2	0	1	1	5
OG0005833	1	0	1	0	2	1	5
OG0005834	1	0	1	1	1	1	5
OG0005835	1	1	1	0	1	1	5
OG0005836	1	1	1	1	0	1	5
OG0005837	1	0	1	1	1	1	5
OG0005838	2	0	1	1	1	0	5
OG0005839	1	1	1	0	2	0	5
OG0005840	1	0	1	1	1	1	5
OG0005841	1	0	1	1	1	1	5
OG0005842	1	1	1	1	1	0	5
OG0005843	1	0	1	1	1	1	5
OG0005844	1	0	1	1	1	1	5
OG0005845	1	0	2	0	1	1	5
OG0005846	1	0	1	1	1	1	5
OG0005847	1	1	1	0	1	1	5
OG0005848	1	1	1	1	1	0	5
OG0005849	1	0	1	1	1	1	5
OG0005850	1	1	1	1	1	0	5
OG0005851	1	0	1	1	1	1	5
OG0005852	1	1	1	1	0	1	5
OG0005853	1	1	1	0	1	1	5
OG0005854	1	1	1	1	0	1	5
OG0005855	1	0	1	1	1	1	5
OG0005856	1	1	1	0	1	1	5
OG0005857	1	1	0	1	1	1	5
OG0005858	1	2	0	1	1	0	5
OG0005859	1	0	1	1	1	1	5
OG0005860	1	0	2	0	1	1	5
OG0005861	1	0	1	1	1	1	5
OG0005862	1	1	1	0	1	1	5
OG0005863	1	0	1	1	1	1	5
OG0005864	2	0	1	1	1	0	5
OG0005865	1	1	1	1	0	1	5
OG0005866	1	2	1	1	0	0	5
OG0005867	1	0	1	1	1	1	5
OG0005868	1	1	1	0	1	1	5
OG0005869	1	1	1	1	1	0	5
OG0005870	1	1	1	0	1	1	5
OG0005871	1	1	1	1	1	0	5
OG0005872	1	0	1	2	0	1	5
OG0005873	1	1	0	1	1	1	5
OG0005874	1	0	1	1	1	1	5
OG0005875	1	1	1	1	1	0	5
OG0005876	1	1	1	0	0	2	5
OG0005877	1	1	1	1	1	0	5
OG0005878	1	0	1	1	1	1	5
OG0005879	1	1	1	2	0	0	5
OG0005880	1	0	2	2	0	0	5
OG0005881	1	0	1	1	1	1	5
OG0005882	1	0	1	1	1	1	5
OG0005883	1	1	1	1	1	0	5
OG0005884	1	0	1	1	1	1	5
OG0005885	1	0	1	2	1	0	5
OG0005886	1	0	1	1	1	1	5
OG0005887	0	2	0	1	1	1	5
OG0005888	0	1	0	1	1	2	5
OG0005889	0	1	1	1	1	1	5
OG0005890	0	2	1	2	0	0	5
OG0005891	0	1	1	1	1	1	5
OG0005892	0	1	1	1	1	1	5
OG0005893	0	2	1	1	1	0	5
OG0005894	0	1	1	0	2	1	5
OG0005895	0	3	1	0	1	0	5
OG0005896	0	3	1	0	0	1	5
OG0005897	0	2	1	1	0	1	5
OG0005898	0	1	1	1	1	1	5
OG0005899	0	1	1	1	0	2	5
OG0005900	0	2	1	1	0	1	5
OG0005901	0	1	2	0	2	0	5
OG0005902	0	1	1	1	1	1	5
OG0005903	0	2	1	0	0	2	5
OG0005904	0	2	1	1	1	0	5
OG0005905	0	1	1	1	1	1	5
OG0005906	0	2	1	2	0	0	5
OG0005907	0	1	1	0	2	1	5
OG0005908	0	3	1	0	1	0	5
OG0005909	0	2	1	1	0	1	5
OG0005910	0	1	1	1	1	1	5
OG0005911	0	2	1	1	0	1	5
OG0005912	0	2	1	0	1	1	5
OG0005913	0	1	1	2	1	0	5
OG0005914	0	1	1	1	1	1	5
OG0005915	0	1	1	1	1	1	5
OG0005916	0	1	1	1	1	1	5
OG0005917	0	2	1	1	0	1	5
OG0005918	0	1	1	1	1	1	5
OG0005919	0	1	1	1	1	1	5
OG0005920	0	1	2	1	1	0	5
OG0005921	0	1	1	1	1	1	5
OG0005922	0	1	1	2	0	1	5
OG0005923	0	1	1	1	1	1	5
OG0005924	0	1	1	1	1	1	5
OG0005925	0	1	1	1	1	1	5
OG0005926	0	1	1	1	1	1	5
OG0005927	0	1	1	1	1	1	5
OG0005928	0	1	1	1	1	1	5
OG0005929	0	1	1	0	2	1	5
OG0005930	0	1	1	1	1	1	5
OG0005931	0	2	1	0	1	1	5
OG0005932	0	3	0	2	0	0	5
OG0005933	0	1	1	1	1	1	5
OG0005934	0	2	1	0	2	0	5
OG0005935	0	3	1	0	1	0	5
OG0005936	0	1	1	1	2	0	5
OG0005937	0	1	1	2	1	0	5
OG0005938	0	1	1	1	1	1	5
OG0005939	0	1	1	1	1	1	5
OG0005940	0	2	1	0	2	0	5
OG0005941	0	1	1	1	1	1	5
OG0005942	0	2	0	0	3	0	5
OG0005943	0	1	1	1	2	0	5
OG0005944	0	1	1	1	1	1	5
OG0005945	0	1	1	1	1	1	5
OG0005946	0	1	1	1	2	0	5
OG0005947	0	1	1	1	2	0	5
OG0005948	0	1	1	1	1	1	5
OG0005949	0	1	1	2	1	0	5
OG0005950	0	1	1	2	0	1	5
OG0005951	0	2	1	1	1	0	5
OG0005952	0	1	1	2	0	1	5
OG0005953	0	1	1	1	1	1	5
OG0005954	0	2	0	1	0	2	5
OG0005955	0	2	1	1	0	1	5
OG0005956	0	2	1	1	0	1	5
OG0005957	0	1	1	1	1	1	5
OG0005958	0	1	1	1	1	1	5
OG0005959	0	1	1	1	1	1	5
OG0005960	0	2	0	1	1	1	5
OG0005961	0	1	1	1	0	2	5
OG0005962	0	1	1	0	2	1	5
OG0005963	0	1	1	1	1	1	5
OG0005964	0	1	1	1	1	1	5
OG0005965	0	1	1	2	1	0	5
OG0005966	0	1	1	1	1	1	5
OG0005967	0	1	1	2	1	0	5
OG0005968	0	1	1	1	1	1	5
OG0005969	0	1	1	1	1	1	5
OG0005970	0	1	1	2	1	0	5
OG0005971	0	1	1	1	1	1	5
OG0005972	0	1	1	1	1	1	5
OG0005973	0	2	1	1	1	0	5
OG0005974	0	1	1	1	1	1	5
OG0005975	0	1	1	1	1	1	5
OG0005976	0	2	1	0	1	1	5
OG0005977	0	1	1	1	1	1	5
OG0005978	0	4	1	0	0	0	5
OG0005979	0	1	1	1	1	1	5
OG0005980	0	2	1	0	1	1	5
OG0005981	0	1	1	1	0	2	5
OG0005982	0	1	1	0	1	2	5
OG0005983	0	1	1	1	0	2	5
OG0005984	0	2	1	0	1	1	5
OG0005985	0	2	1	1	1	0	5
OG0005986	0	1	1	1	0	2	5
OG0005987	0	1	1	1	1	1	5
OG0005988	0	3	1	0	0	1	5
OG0005989	0	1	1	1	1	1	5
OG0005990	0	1	1	1	1	1	5
OG0005991	0	2	1	1	0	1	5
OG0005992	0	2	1	1	1	0	5
OG0005993	0	2	1	0	1	1	5
OG0005994	0	2	1	1	1	0	5
OG0005995	0	1	1	1	0	2	5
OG0005996	0	1	1	1	1	1	5
OG0005997	0	2	1	1	1	0	5
OG0005998	0	1	2	1	1	0	5
OG0005999	0	1	1	2	1	0	5
OG0006000	0	1	1	1	1	1	5
OG0006001	0	1	1	1	1	1	5
OG0006002	0	2	1	1	0	1	5
OG0006003	0	1	1	2	1	0	5
OG0006004	0	1	0	1	2	1	5
OG0006005	0	1	1	1	1	1	5
OG0006006	0	1	1	1	1	1	5
OG0006007	0	1	1	1	1	1	5
OG0006008	0	1	1	1	1	1	5
OG0006009	0	1	1	1	1	1	5
OG0006010	0	2	1	1	0	1	5
OG0006011	0	2	1	1	0	1	5
OG0006012	0	1	1	2	0	1	5
OG0006013	0	1	1	1	1	1	5
OG0006014	0	1	1	1	1	1	5
OG0006015	0	1	1	1	1	1	5
OG0006016	0	1	1	1	1	1	5
OG0006017	0	5	0	0	0	0	5
OG0006018	0	2	1	0	1	1	5
OG0006019	0	2	1	1	1	0	5
OG0006020	0	1	1	1	1	1	5
OG0006021	0	2	0	1	1	1	5
OG0006022	0	1	1	1	2	0	5
OG0006023	0	1	1	1	1	1	5
OG0006024	0	2	1	0	1	1	5
OG0006025	0	1	1	1	1	1	5
OG0006026	0	1	1	1	1	1	5
OG0006027	0	1	1	1	1	1	5
OG0006028	0	2	1	1	1	0	5
OG0006029	0	2	1	1	1	0	5
OG0006030	0	1	1	1	1	1	5
OG0006031	0	1	0	3	0	1	5
OG0006032	0	2	1	1	1	0	5
OG0006033	0	2	1	0	1	1	5
OG0006034	0	1	1	1	1	1	5
OG0006035	0	2	1	0	2	0	5
OG0006036	0	1	1	1	1	1	5
OG0006037	0	1	1	2	1	0	5
OG0006038	0	1	1	1	1	1	5
OG0006039	0	1	1	1	1	1	5
OG0006040	0	1	1	1	1	1	5
OG0006041	0	2	1	0	1	1	5
OG0006042	0	1	1	1	1	1	5
OG0006043	0	1	1	1	1	1	5
OG0006044	0	2	1	1	1	0	5
OG0006045	0	2	1	1	0	1	5
OG0006046	0	1	1	1	1	1	5
OG0006047	0	1	1	0	1	2	5
OG0006048	0	2	0	0	1	2	5
OG0006049	0	2	1	1	1	0	5
OG0006050	0	1	1	0	2	1	5
OG0006051	0	1	1	0	1	2	5
OG0006052	0	1	1	1	1	1	5
OG0006053	0	1	1	0	1	2	5
OG0006054	0	2	1	1	1	0	5
OG0006055	0	1	1	1	1	1	5
OG0006056	0	1	1	1	1	1	5
OG0006057	0	1	1	1	1	1	5
OG0006058	0	1	1	1	1	1	5
OG0006059	0	2	1	1	1	0	5
OG0006060	0	1	1	1	1	1	5
OG0006061	0	2	1	0	1	1	5
OG0006062	0	1	1	1	1	1	5
OG0006063	0	4	0	1	0	0	5
OG0006064	0	1	1	1	1	1	5
OG0006065	0	1	1	1	1	1	5
OG0006066	0	2	1	0	1	1	5
OG0006067	0	1	1	1	1	1	5
OG0006068	0	1	1	1	1	1	5
OG0006069	0	1	1	1	1	1	5
OG0006070	0	1	1	1	1	1	5
OG0006071	0	2	1	1	0	1	5
OG0006072	0	2	1	1	0	1	5
OG0006073	0	1	1	2	0	1	5
OG0006074	0	1	0	1	1	2	5
OG0006075	0	1	1	1	1	1	5
OG0006076	0	1	1	1	0	2	5
OG0006077	0	2	1	1	0	1	5
OG0006078	0	1	1	1	0	2	5
OG0006079	0	1	1	1	1	1	5
OG0006080	0	1	1	2	1	0	5
OG0006081	0	1	1	1	1	1	5
OG0006082	0	1	2	0	1	1	5
OG0006083	0	1	1	1	1	1	5
OG0006084	0	1	1	1	0	2	5
OG0006085	0	1	1	1	1	1	5
OG0006086	0	1	2	2	0	0	5
OG0006087	0	1	1	1	1	1	5
OG0006088	0	1	0	2	1	1	5
OG0006089	0	1	1	1	1	1	5
OG0006090	0	1	1	2	0	1	5
OG0006091	0	3	1	0	0	1	5
OG0006092	0	1	1	1	1	1	5
OG0006093	0	1	1	0	2	1	5
OG0006094	0	1	1	1	1	1	5
OG0006095	0	1	1	1	1	1	5
OG0006096	0	1	1	1	1	1	5
OG0006097	0	1	1	1	1	1	5
OG0006098	0	2	0	0	1	2	5
OG0006099	0	1	1	1	1	1	5
OG0006100	0	1	1	1	1	1	5
OG0006101	0	2	1	1	1	0	5
OG0006102	0	1	1	0	2	1	5
OG0006103	0	1	1	1	1	1	5
OG0006104	0	1	1	1	1	1	5
OG0006105	0	1	1	1	1	1	5
OG0006106	0	1	0	0	0	4	5
OG0006107	0	1	1	1	1	1	5
OG0006108	0	2	1	0	0	2	5
OG0006109	0	1	1	1	1	1	5
OG0006110	0	1	1	1	1	1	5
OG0006111	0	1	1	1	1	1	5
OG0006112	0	3	2	0	0	0	5
OG0006113	0	1	1	1	1	1	5
OG0006114	0	1	1	0	1	2	5
OG0006115	0	1	1	1	1	1	5
OG0006116	0	1	1	1	1	1	5
OG0006117	0	1	1	1	1	1	5
OG0006118	0	1	1	1	1	1	5
OG0006119	0	1	1	1	1	1	5
OG0006120	0	1	1	2	1	0	5
OG0006121	0	2	1	0	1	1	5
OG0006122	0	2	1	1	1	0	5
OG0006123	0	1	0	1	1	2	5
OG0006124	0	1	1	1	1	1	5
OG0006125	0	1	0	3	0	1	5
OG0006126	0	1	1	1	2	0	5
OG0006127	0	1	1	1	1	1	5
OG0006128	0	1	1	1	1	1	5
OG0006129	0	1	1	1	1	1	5
OG0006130	0	5	0	0	0	0	5
OG0006131	0	1	1	1	1	1	5
OG0006132	0	1	1	1	0	2	5
OG0006133	0	1	1	1	1	1	5
OG0006134	0	1	1	1	1	1	5
OG0006135	0	4	0	1	0	0	5
OG0006136	0	1	1	0	1	2	5
OG0006137	0	1	1	2	0	1	5
OG0006138	0	1	1	2	1	0	5
OG0006139	0	2	1	1	1	0	5
OG0006140	0	1	1	0	1	2	5
OG0006141	0	2	1	1	1	0	5
OG0006142	0	1	1	0	2	1	5
OG0006143	0	1	1	1	1	1	5
OG0006144	0	1	1	1	1	1	5
OG0006145	0	3	1	0	0	1	5
OG0006146	0	4	0	0	1	0	5
OG0006147	0	1	1	1	1	1	5
OG0006148	0	2	1	0	1	1	5
OG0006149	0	4	1	0	0	0	5
OG0006150	0	1	0	0	0	4	5
OG0006151	0	1	1	1	1	1	5
OG0006152	0	0	1	1	1	2	5
OG0006153	0	0	1	2	1	1	5
OG0006154	0	0	1	1	1	2	5
OG0006155	0	0	1	1	1	2	5
OG0006156	0	0	1	2	1	1	5
OG0006157	0	0	5	0	0	0	5
OG0006158	0	0	2	1	1	1	5
OG0006159	0	0	3	2	0	0	5
OG0006160	0	0	4	0	1	0	5
OG0006161	0	0	5	0	0	0	5
OG0006162	0	0	2	1	1	1	5
OG0006163	0	0	1	2	1	1	5
OG0006164	0	0	5	0	0	0	5
OG0006165	0	0	5	0	0	0	5
OG0006166	0	0	1	1	2	1	5
OG0006167	0	0	2	1	1	1	5
OG0006168	0	0	2	0	2	1	5
OG0006169	0	0	3	0	1	1	5
OG0006170	0	0	1	2	0	2	5
OG0006171	0	0	1	1	2	1	5
OG0006172	0	0	1	0	1	3	5
OG0006173	0	0	1	1	1	2	5
OG0006174	0	0	1	3	1	0	5
OG0006175	0	0	1	0	2	2	5
OG0006176	0	0	1	1	1	2	5
OG0006177	0	0	1	2	1	1	5
OG0006178	0	0	1	1	1	2	5
OG0006179	0	0	5	0	0	0	5
OG0006180	0	0	1	2	0	2	5
OG0006181	0	0	1	2	1	1	5
OG0006182	0	0	1	1	2	1	5
OG0006183	0	0	1	1	1	2	5
OG0006184	0	0	5	0	0	0	5
OG0006185	0	0	1	1	1	2	5
OG0006186	0	0	1	2	0	2	5
OG0006187	0	0	1	2	1	1	5
OG0006188	0	0	1	1	2	1	5
OG0006189	0	0	1	2	1	1	5
OG0006190	0	0	1	1	2	1	5
OG0006191	0	0	1	2	1	1	5
OG0006192	0	0	1	1	1	2	5
OG0006193	0	0	1	2	1	1	5
OG0006194	0	0	1	1	2	1	5
OG0006195	0	0	2	1	0	2	5
OG0006196	0	0	1	2	1	1	5
OG0006197	0	0	1	1	2	1	5
OG0006198	0	0	1	1	2	1	5
OG0006199	0	0	1	1	2	1	5
OG0006200	0	0	1	0	2	2	5
OG0006201	0	0	1	1	2	1	5
OG0006202	0	0	1	2	1	1	5
OG0006203	0	0	1	2	1	1	5
OG0006204	0	0	1	1	1	2	5
OG0006205	0	0	1	2	0	2	5
OG0006206	0	0	1	2	1	1	5
OG0006207	0	0	1	1	2	1	5
OG0006208	0	0	1	1	2	1	5
OG0006209	0	0	1	2	0	2	5
OG0006210	0	0	1	2	1	1	5
OG0006211	0	0	2	1	2	0	5
OG0006212	0	0	1	3	1	0	5
OG0006213	0	0	1	2	1	1	5
OG0006214	0	0	1	1	2	1	5
OG0006215	0	0	1	2	1	1	5
OG0006216	0	0	1	2	1	1	5
OG0006217	0	0	1	1	1	2	5
OG0006218	0	0	1	2	1	1	5
OG0006219	0	0	1	0	3	1	5
OG0006220	0	0	1	1	2	1	5
OG0006221	0	0	1	3	1	0	5
OG0006222	0	0	1	1	2	1	5
OG0006223	0	0	1	0	4	0	5
OG0006224	0	0	1	3	1	0	5
OG0006225	0	0	1	1	2	1	5
OG0006226	0	0	1	1	0	3	5
OG0006227	0	0	1	1	1	2	5
OG0006228	0	0	1	1	1	2	5
OG0006229	0	0	1	1	2	1	5
OG0006230	0	0	1	1	1	2	5
OG0006231	0	0	1	1	2	1	5
OG0006232	0	0	1	1	2	1	5
OG0006233	0	0	1	2	1	1	5
OG0006234	0	0	1	2	1	1	5
OG0006235	0	0	3	0	1	1	5
OG0006236	0	0	1	1	2	1	5
OG0006237	0	0	1	2	1	1	5
OG0006238	0	0	1	1	1	2	5
OG0006239	0	0	1	0	1	3	5
OG0006240	0	0	1	1	2	1	5
OG0006241	0	0	1	1	2	1	5
OG0006242	0	0	1	1	1	2	5
OG0006243	0	0	1	0	1	3	5
OG0006244	0	0	1	2	1	1	5
OG0006245	0	0	2	1	1	1	5
OG0006246	0	0	0	5	0	0	5
OG0006247	0	0	0	5	0	0	5
OG0006248	0	0	0	2	3	0	5
OG0006249	0	0	0	5	0	0	5
OG0006250	0	0	0	5	0	0	5
OG0006251	0	0	0	2	2	1	5
OG0006252	0	0	0	5	0	0	5
OG0006253	0	0	0	1	0	4	5
OG0006254	0	0	0	2	2	1	5
OG0006255	0	0	0	3	1	1	5
OG0006256	0	0	0	2	1	2	5
OG0006257	0	0	0	4	0	1	5
OG0006258	0	0	0	1	1	3	5
OG0006259	0	0	0	0	3	2	5
OG0006260	0	0	0	0	4	1	5
OG0006261	0	0	0	0	4	1	5
OG0006262	0	0	0	0	1	4	5
OG0006263	0	0	0	0	1	4	5
OG0006264	0	0	0	0	2	3	5
OG0006265	0	0	0	0	1	4	5
OG0006266	0	0	0	0	1	4	5
OG0006267	0	0	0	0	0	5	5
OG0006268	0	0	0	0	0	5	5
OG0006269	1	0	1	0	1	1	4
OG0006270	1	0	1	0	1	1	4
OG0006271	1	0	1	0	1	1	4
OG0006272	1	1	1	0	0	1	4
OG0006273	1	0	1	0	1	1	4
OG0006274	2	1	0	1	0	0	4
OG0006275	1	1	1	0	0	1	4
OG0006276	1	1	1	0	0	1	4
OG0006277	1	1	0	1	0	1	4
OG0006278	1	0	1	0	1	1	4
OG0006279	1	1	1	0	1	0	4
OG0006280	1	0	1	1	1	0	4
OG0006281	1	1	1	1	0	0	4
OG0006282	2	0	1	1	0	0	4
OG0006283	1	0	1	0	1	1	4
OG0006284	1	1	1	0	0	1	4
OG0006285	1	0	1	1	1	0	4
OG0006286	1	0	1	0	1	1	4
OG0006287	2	0	1	0	1	0	4
OG0006288	1	0	1	1	0	1	4
OG0006289	1	0	1	1	0	1	4
OG0006290	1	1	1	1	0	0	4
OG0006291	1	0	1	0	1	1	4
OG0006292	3	0	1	0	0	0	4
OG0006293	1	0	1	0	1	1	4
OG0006294	1	0	1	0	1	1	4
OG0006295	1	1	1	0	1	0	4
OG0006296	1	0	1	0	0	2	4
OG0006297	1	1	1	1	0	0	4
OG0006298	4	0	0	0	0	0	4
OG0006299	1	2	0	1	0	0	4
OG0006300	1	0	1	1	1	0	4
OG0006301	4	0	0	0	0	0	4
OG0006302	1	0	1	1	0	1	4
OG0006303	3	0	1	0	0	0	4
OG0006304	2	0	1	1	0	0	4
OG0006305	1	1	1	0	1	0	4
OG0006306	1	0	1	1	0	1	4
OG0006307	4	0	0	0	0	0	4
OG0006308	2	0	0	1	1	0	4
OG0006309	1	0	1	1	1	0	4
OG0006310	1	1	1	0	1	0	4
OG0006311	3	0	1	0	0	0	4
OG0006312	1	1	1	1	0	0	4
OG0006313	2	0	1	0	0	1	4
OG0006314	1	0	1	1	0	1	4
OG0006315	1	0	1	1	1	0	4
OG0006316	2	1	1	0	0	0	4
OG0006317	4	0	0	0	0	0	4
OG0006318	4	0	0	0	0	0	4
OG0006319	1	0	1	1	1	0	4
OG0006320	1	1	0	0	1	1	4
OG0006321	2	1	1	0	0	0	4
OG0006322	2	0	1	0	0	1	4
OG0006323	1	0	1	1	0	1	4
OG0006324	1	0	1	1	1	0	4
OG0006325	1	0	1	1	0	1	4
OG0006326	1	0	1	1	1	0	4
OG0006327	1	0	1	0	1	1	4
OG0006328	4	0	0	0	0	0	4
OG0006329	4	0	0	0	0	0	4
OG0006330	1	0	1	1	0	1	4
OG0006331	1	0	1	0	1	1	4
OG0006332	1	1	1	0	1	0	4
OG0006333	1	0	1	0	2	0	4
OG0006334	1	0	1	0	1	1	4
OG0006335	2	2	0	0	0	0	4
OG0006336	1	1	1	0	0	1	4
OG0006337	1	0	1	1	0	1	4
OG0006338	2	0	1	0	1	0	4
OG0006339	1	0	1	1	0	1	4
OG0006340	1	0	1	0	2	0	4
OG0006341	1	1	1	1	0	0	4
OG0006342	4	0	0	0	0	0	4
OG0006343	2	1	0	1	0	0	4
OG0006344	2	0	1	0	0	1	4
OG0006345	1	1	1	0	0	1	4
OG0006346	2	0	1	1	0	0	4
OG0006347	1	1	1	0	1	0	4
OG0006348	1	0	1	1	0	1	4
OG0006349	1	0	2	1	0	0	4
OG0006350	1	0	1	1	0	1	4
OG0006351	1	0	1	1	0	1	4
OG0006352	1	0	1	1	0	1	4
OG0006353	1	0	1	1	0	1	4
OG0006354	1	0	1	0	0	2	4
OG0006355	2	0	1	0	1	0	4
OG0006356	1	0	1	1	1	0	4
OG0006357	2	0	0	2	0	0	4
OG0006358	1	0	1	1	0	1	4
OG0006359	1	0	1	0	1	1	4
OG0006360	1	1	0	0	1	1	4
OG0006361	1	0	1	1	1	0	4
OG0006362	1	1	0	1	1	0	4
OG0006363	1	0	1	1	0	1	4
OG0006364	1	0	1	1	1	0	4
OG0006365	1	2	0	1	0	0	4
OG0006366	1	1	0	1	1	0	4
OG0006367	1	0	1	1	0	1	4
OG0006368	2	2	0	0	0	0	4
OG0006369	1	0	1	1	0	1	4
OG0006370	1	0	0	1	1	1	4
OG0006371	2	0	1	0	0	1	4
OG0006372	1	0	1	0	1	1	4
OG0006373	1	0	1	2	0	0	4
OG0006374	3	1	0	0	0	0	4
OG0006375	1	1	1	1	0	0	4
OG0006376	2	0	1	0	0	1	4
OG0006377	1	1	1	1	0	0	4
OG0006378	2	0	1	0	1	0	4
OG0006379	1	2	0	1	0	0	4
OG0006380	1	0	1	1	1	0	4
OG0006381	1	1	1	0	1	0	4
OG0006382	1	0	1	0	1	1	4
OG0006383	2	0	1	0	1	0	4
OG0006384	1	0	1	1	1	0	4
OG0006385	1	0	1	1	1	0	4
OG0006386	1	0	1	0	1	1	4
OG0006387	4	0	0	0	0	0	4
OG0006388	1	0	1	1	1	0	4
OG0006389	1	1	0	0	0	2	4
OG0006390	1	0	1	0	1	1	4
OG0006391	1	1	1	0	1	0	4
OG0006392	1	0	1	0	1	1	4
OG0006393	1	1	1	1	0	0	4
OG0006394	1	1	1	0	1	0	4
OG0006395	1	1	1	0	1	0	4
OG0006396	1	0	1	1	0	1	4
OG0006397	1	1	1	0	0	1	4
OG0006398	1	0	1	1	1	0	4
OG0006399	1	0	1	1	1	0	4
OG0006400	1	0	1	1	1	0	4
OG0006401	1	0	1	0	2	0	4
OG0006402	1	0	1	1	1	0	4
OG0006403	1	0	1	0	0	2	4
OG0006404	1	0	1	1	0	1	4
OG0006405	1	1	1	1	0	0	4
OG0006406	1	0	1	1	1	0	4
OG0006407	1	0	0	1	1	1	4
OG0006408	1	0	1	1	1	0	4
OG0006409	1	1	1	0	1	0	4
OG0006410	1	0	1	1	0	1	4
OG0006411	1	0	1	1	0	1	4
OG0006412	1	0	1	1	0	1	4
OG0006413	1	0	1	1	1	0	4
OG0006414	1	1	1	0	0	1	4
OG0006415	1	1	1	1	0	0	4
OG0006416	1	1	1	0	1	0	4
OG0006417	1	1	0	1	1	0	4
OG0006418	1	0	2	0	1	0	4
OG0006419	1	0	1	0	1	1	4
OG0006420	1	0	1	1	0	1	4
OG0006421	1	0	2	0	0	1	4
OG0006422	1	1	0	1	1	0	4
OG0006423	1	1	1	1	0	0	4
OG0006424	1	1	1	0	1	0	4
OG0006425	1	0	1	0	1	1	4
OG0006426	1	1	1	0	1	0	4
OG0006427	1	2	1	0	0	0	4
OG0006428	1	0	1	1	1	0	4
OG0006429	1	1	0	1	1	0	4
OG0006430	4	0	0	0	0	0	4
OG0006431	1	0	1	1	1	0	4
OG0006432	1	0	1	1	0	1	4
OG0006433	1	0	1	1	0	1	4
OG0006434	1	0	1	0	1	1	4
OG0006435	1	1	1	1	0	0	4
OG0006436	1	1	1	0	0	1	4
OG0006437	1	1	0	1	1	0	4
OG0006438	1	1	1	1	0	0	4
OG0006439	1	0	1	1	0	1	4
OG0006440	1	0	1	0	1	1	4
OG0006441	4	0	0	0	0	0	4
OG0006442	1	0	1	1	1	0	4
OG0006443	1	1	1	0	0	1	4
OG0006444	1	1	1	1	0	0	4
OG0006445	2	1	1	0	0	0	4
OG0006446	1	1	1	1	0	0	4
OG0006447	2	0	1	0	1	0	4
OG0006448	1	1	1	0	1	0	4
OG0006449	1	0	1	0	1	1	4
OG0006450	1	1	0	0	1	1	4
OG0006451	1	0	1	0	1	1	4
OG0006452	1	0	1	1	1	0	4
OG0006453	1	0	1	0	1	1	4
OG0006454	1	1	1	0	0	1	4
OG0006455	1	0	1	2	0	0	4
OG0006456	1	0	1	1	1	0	4
OG0006457	1	0	1	1	1	0	4
OG0006458	1	0	1	1	0	1	4
OG0006459	1	0	1	2	0	0	4
OG0006460	1	0	1	1	0	1	4
OG0006461	1	1	1	1	0	0	4
OG0006462	1	1	1	0	0	1	4
OG0006463	1	1	1	0	0	1	4
OG0006464	1	0	1	1	0	1	4
OG0006465	1	0	1	0	1	1	4
OG0006466	1	0	1	1	0	1	4
OG0006467	1	0	1	1	1	0	4
OG0006468	2	1	1	0	0	0	4
OG0006469	1	1	1	0	1	0	4
OG0006470	1	0	1	1	1	0	4
OG0006471	1	0	1	1	1	0	4
OG0006472	1	1	1	1	0	0	4
OG0006473	1	0	1	1	0	1	4
OG0006474	1	1	1	1	0	0	4
OG0006475	1	1	1	1	0	0	4
OG0006476	2	0	1	1	0	0	4
OG0006477	2	0	1	1	0	0	4
OG0006478	1	1	1	1	0	0	4
OG0006479	1	0	1	1	1	0	4
OG0006480	1	0	1	1	0	1	4
OG0006481	1	1	1	1	0	0	4
OG0006482	1	0	1	1	1	0	4
OG0006483	3	0	1	0	0	0	4
OG0006484	2	0	1	0	0	1	4
OG0006485	1	1	1	0	1	0	4
OG0006486	4	0	0	0	0	0	4
OG0006487	1	1	0	1	1	0	4
OG0006488	1	0	1	1	1	0	4
OG0006489	2	1	1	0	0	0	4
OG0006490	1	0	3	0	0	0	4
OG0006491	1	0	1	1	1	0	4
OG0006492	1	1	1	0	1	0	4
OG0006493	1	0	1	1	1	0	4
OG0006494	1	1	1	0	0	1	4
OG0006495	1	1	1	0	1	0	4
OG0006496	1	0	1	0	1	1	4
OG0006497	1	1	0	1	1	0	4
OG0006498	1	0	1	1	0	1	4
OG0006499	3	1	0	0	0	0	4
OG0006500	4	0	0	0	0	0	4
OG0006501	3	0	1	0	0	0	4
OG0006502	1	0	1	0	1	1	4
OG0006503	1	1	1	0	1	0	4
OG0006504	1	1	1	0	0	1	4
OG0006505	2	0	1	0	1	0	4
OG0006506	4	0	0	0	0	0	4
OG0006507	1	0	2	0	1	0	4
OG0006508	1	0	1	1	1	0	4
OG0006509	1	0	1	0	1	1	4
OG0006510	1	0	1	1	1	0	4
OG0006511	1	0	1	1	0	1	4
OG0006512	2	1	1	0	0	0	4
OG0006513	1	0	1	1	1	0	4
OG0006514	2	0	1	0	0	1	4
OG0006515	1	0	1	1	1	0	4
OG0006516	4	0	0	0	0	0	4
OG0006517	1	0	1	1	1	0	4
OG0006518	1	0	1	0	0	2	4
OG0006519	1	0	1	0	1	1	4
OG0006520	1	3	0	0	0	0	4
OG0006521	1	1	1	1	0	0	4
OG0006522	4	0	0	0	0	0	4
OG0006523	4	0	0	0	0	0	4
OG0006524	2	0	1	0	0	1	4
OG0006525	1	0	1	1	0	1	4
OG0006526	1	0	1	1	1	0	4
OG0006527	1	0	1	0	1	1	4
OG0006528	4	0	0	0	0	0	4
OG0006529	1	1	1	0	0	1	4
OG0006530	1	0	1	1	1	0	4
OG0006531	2	0	1	0	1	0	4
OG0006532	1	1	1	0	0	1	4
OG0006533	1	1	0	1	0	1	4
OG0006534	1	1	1	0	1	0	4
OG0006535	1	0	1	0	1	1	4
OG0006536	1	0	1	0	1	1	4
OG0006537	4	0	0	0	0	0	4
OG0006538	1	1	1	0	0	1	4
OG0006539	1	0	1	0	1	1	4
OG0006540	1	1	1	0	0	1	4
OG0006541	1	1	1	0	1	0	4
OG0006542	1	0	1	1	1	0	4
OG0006543	1	1	1	0	1	0	4
OG0006544	1	1	1	0	0	1	4
OG0006545	1	1	1	0	1	0	4
OG0006546	1	0	1	0	1	1	4
OG0006547	1	1	1	1	0	0	4
OG0006548	1	0	1	1	0	1	4
OG0006549	1	1	0	1	0	1	4
OG0006550	1	0	1	1	0	1	4
OG0006551	1	0	1	0	1	1	4
OG0006552	1	1	1	0	0	1	4
OG0006553	1	0	1	0	1	1	4
OG0006554	1	0	1	0	1	1	4
OG0006555	1	0	1	1	0	1	4
OG0006556	4	0	0	0	0	0	4
OG0006557	1	0	1	1	0	1	4
OG0006558	1	0	1	0	1	1	4
OG0006559	1	1	1	0	0	1	4
OG0006560	1	1	1	0	1	0	4
OG0006561	1	0	1	0	1	1	4
OG0006562	1	0	1	0	1	1	4
OG0006563	4	0	0	0	0	0	4
OG0006564	1	0	1	0	0	2	4
OG0006565	1	1	1	0	1	0	4
OG0006566	1	1	1	1	0	0	4
OG0006567	1	1	0	1	0	1	4
OG0006568	1	0	1	1	0	1	4
OG0006569	2	0	1	0	1	0	4
OG0006570	1	1	1	0	0	1	4
OG0006571	1	0	0	2	0	1	4
OG0006572	1	0	1	0	1	1	4
OG0006573	1	0	1	1	1	0	4
OG0006574	1	0	1	1	1	0	4
OG0006575	1	0	1	0	1	1	4
OG0006576	4	0	0	0	0	0	4
OG0006577	1	1	1	1	0	0	4
OG0006578	1	0	1	1	0	1	4
OG0006579	1	1	1	0	1	0	4
OG0006580	1	0	1	1	0	1	4
OG0006581	4	0	0	0	0	0	4
OG0006582	1	0	1	0	1	1	4
OG0006583	2	0	1	0	0	1	4
OG0006584	1	1	1	1	0	0	4
OG0006585	1	1	1	1	0	0	4
OG0006586	4	0	0	0	0	0	4
OG0006587	1	0	1	1	1	0	4
OG0006588	1	0	1	1	0	1	4
OG0006589	1	1	1	1	0	0	4
OG0006590	1	1	1	0	0	1	4
OG0006591	1	0	1	1	1	0	4
OG0006592	2	0	1	1	0	0	4
OG0006593	1	1	1	0	1	0	4
OG0006594	1	1	1	1	0	0	4
OG0006595	1	1	0	1	0	1	4
OG0006596	1	0	1	1	1	0	4
OG0006597	1	0	1	1	1	0	4
OG0006598	1	0	1	1	0	1	4
OG0006599	1	2	0	1	0	0	4
OG0006600	1	0	1	0	1	1	4
OG0006601	1	2	1	0	0	0	4
OG0006602	2	0	1	1	0	0	4
OG0006603	1	1	1	0	0	1	4
OG0006604	1	0	1	0	1	1	4
OG0006605	1	1	1	0	1	0	4
OG0006606	1	1	1	0	0	1	4
OG0006607	1	0	1	1	0	1	4
OG0006608	1	0	1	0	1	1	4
OG0006609	1	1	1	0	1	0	4
OG0006610	1	0	1	0	1	1	4
OG0006611	1	0	1	0	1	1	4
OG0006612	1	0	1	1	0	1	4
OG0006613	1	0	1	1	1	0	4
OG0006614	1	0	1	1	0	1	4
OG0006615	1	0	1	1	1	0	4
OG0006616	1	0	1	1	0	1	4
OG0006617	1	0	1	1	1	0	4
OG0006618	1	0	1	1	0	1	4
OG0006619	1	0	1	1	0	1	4
OG0006620	1	0	1	1	1	0	4
OG0006621	1	0	1	1	1	0	4
OG0006622	1	0	1	1	1	0	4
OG0006623	1	0	1	1	1	0	4
OG0006624	1	0	1	1	0	1	4
OG0006625	1	1	1	1	0	0	4
OG0006626	1	1	1	1	0	0	4
OG0006627	1	0	1	2	0	0	4
OG0006628	1	1	1	0	1	0	4
OG0006629	1	1	1	1	0	0	4
OG0006630	2	1	0	0	1	0	4
OG0006631	1	0	1	1	0	1	4
OG0006632	1	0	1	0	0	2	4
OG0006633	1	0	1	1	1	0	4
OG0006634	1	0	1	1	0	1	4
OG0006635	1	0	1	1	0	1	4
OG0006636	1	0	1	1	1	0	4
OG0006637	1	1	1	0	0	1	4
OG0006638	1	0	1	0	1	1	4
OG0006639	1	0	1	2	0	0	4
OG0006640	1	0	1	1	1	0	4
OG0006641	2	0	0	0	1	1	4
OG0006642	2	2	0	0	0	0	4
OG0006643	2	0	1	0	1	0	4
OG0006644	1	1	1	0	0	1	4
OG0006645	1	1	1	1	0	0	4
OG0006646	1	0	1	0	1	1	4
OG0006647	1	1	1	1	0	0	4
OG0006648	1	1	1	0	1	0	4
OG0006649	1	0	1	0	1	1	4
OG0006650	1	0	1	1	1	0	4
OG0006651	1	0	1	0	1	1	4
OG0006652	1	1	1	0	0	1	4
OG0006653	1	0	1	0	1	1	4
OG0006654	1	0	1	1	0	1	4
OG0006655	1	1	1	0	1	0	4
OG0006656	1	0	1	1	0	1	4
OG0006657	1	2	1	0	0	0	4
OG0006658	1	0	1	1	1	0	4
OG0006659	1	0	1	0	1	1	4
OG0006660	1	0	1	1	1	0	4
OG0006661	1	0	1	0	1	1	4
OG0006662	1	1	1	1	0	0	4
OG0006663	1	1	1	0	1	0	4
OG0006664	1	1	1	0	0	1	4
OG0006665	2	1	0	1	0	0	4
OG0006666	1	1	1	0	1	0	4
OG0006667	1	0	1	1	1	0	4
OG0006668	1	0	1	1	0	1	4
OG0006669	1	0	1	1	1	0	4
OG0006670	1	0	1	0	1	1	4
OG0006671	1	1	1	1	0	0	4
OG0006672	1	0	1	1	1	0	4
OG0006673	1	0	1	1	0	1	4
OG0006674	1	0	1	1	1	0	4
OG0006675	1	0	1	0	1	1	4
OG0006676	1	1	1	0	0	1	4
OG0006677	1	0	1	0	1	1	4
OG0006678	1	1	1	0	0	1	4
OG0006679	2	1	1	0	0	0	4
OG0006680	2	0	1	1	0	0	4
OG0006681	1	1	0	2	0	0	4
OG0006682	1	0	1	1	0	1	4
OG0006683	1	1	1	1	0	0	4
OG0006684	1	0	1	1	0	1	4
OG0006685	2	0	1	1	0	0	4
OG0006686	1	1	1	1	0	0	4
OG0006687	1	1	1	1	0	0	4
OG0006688	1	1	1	1	0	0	4
OG0006689	1	0	0	1	1	1	4
OG0006690	1	0	1	1	0	1	4
OG0006691	1	1	1	1	0	0	4
OG0006692	1	1	1	0	1	0	4
OG0006693	1	0	1	1	1	0	4
OG0006694	1	0	1	1	1	0	4
OG0006695	2	1	0	0	1	0	4
OG0006696	2	0	2	0	0	0	4
OG0006697	1	0	1	1	0	1	4
OG0006698	1	0	0	0	1	2	4
OG0006699	1	0	1	0	1	1	4
OG0006700	3	0	0	0	0	1	4
OG0006701	1	1	1	0	0	1	4
OG0006702	4	0	0	0	0	0	4
OG0006703	1	1	1	1	0	0	4
OG0006704	2	2	0	0	0	0	4
OG0006705	2	0	1	1	0	0	4
OG0006706	1	1	1	0	0	1	4
OG0006707	1	0	1	1	1	0	4
OG0006708	1	0	1	0	1	1	4
OG0006709	1	0	1	1	0	1	4
OG0006710	1	0	1	1	1	0	4
OG0006711	1	1	1	1	0	0	4
OG0006712	1	0	1	1	1	0	4
OG0006713	1	0	1	1	0	1	4
OG0006714	1	0	1	1	0	1	4
OG0006715	2	0	1	1	0	0	4
OG0006716	1	0	1	1	1	0	4
OG0006717	1	1	0	1	1	0	4
OG0006718	1	1	1	0	0	1	4
OG0006719	1	1	1	0	1	0	4
OG0006720	1	0	1	1	0	1	4
OG0006721	1	0	1	1	0	1	4
OG0006722	1	0	1	1	0	1	4
OG0006723	1	0	1	1	0	1	4
OG0006724	1	0	1	1	0	1	4
OG0006725	1	1	0	1	0	1	4
OG0006726	1	0	1	0	1	1	4
OG0006727	1	0	1	0	1	1	4
OG0006728	1	0	1	0	1	1	4
OG0006729	1	0	1	1	0	1	4
OG0006730	1	0	1	0	1	1	4
OG0006731	2	0	1	0	0	1	4
OG0006732	2	0	1	0	1	0	4
OG0006733	1	1	0	0	1	1	4
OG0006734	1	0	1	1	0	1	4
OG0006735	1	0	1	0	1	1	4
OG0006736	1	0	1	0	1	1	4
OG0006737	1	1	1	1	0	0	4
OG0006738	1	0	1	0	1	1	4
OG0006739	2	0	1	0	0	1	4
OG0006740	1	1	1	0	1	0	4
OG0006741	1	0	1	1	1	0	4
OG0006742	1	1	1	0	1	0	4
OG0006743	1	1	1	0	0	1	4
OG0006744	1	0	1	1	1	0	4
OG0006745	1	0	1	1	0	1	4
OG0006746	1	0	1	0	1	1	4
OG0006747	1	1	1	1	0	0	4
OG0006748	1	0	1	0	0	2	4
OG0006749	1	0	1	0	2	0	4
OG0006750	1	0	1	0	2	0	4
OG0006751	1	0	1	0	1	1	4
OG0006752	1	0	1	1	0	1	4
OG0006753	1	0	1	1	0	1	4
OG0006754	1	1	1	1	0	0	4
OG0006755	4	0	0	0	0	0	4
OG0006756	1	0	1	1	1	0	4
OG0006757	1	0	1	0	1	1	4
OG0006758	2	0	1	1	0	0	4
OG0006759	1	0	1	1	1	0	4
OG0006760	1	1	1	0	0	1	4
OG0006761	1	1	1	0	0	1	4
OG0006762	1	0	1	0	1	1	4
OG0006763	1	0	1	0	1	1	4
OG0006764	1	0	1	1	0	1	4
OG0006765	1	1	1	0	0	1	4
OG0006766	1	1	1	0	1	0	4
OG0006767	1	0	1	1	0	1	4
OG0006768	2	0	1	0	1	0	4
OG0006769	1	0	1	1	1	0	4
OG0006770	1	0	1	0	1	1	4
OG0006771	1	0	1	1	0	1	4
OG0006772	1	1	0	0	1	1	4
OG0006773	1	0	1	0	1	1	4
OG0006774	1	0	1	1	0	1	4
OG0006775	1	0	0	1	1	1	4
OG0006776	1	0	1	1	1	0	4
OG0006777	1	2	0	1	0	0	4
OG0006778	1	0	1	1	0	1	4
OG0006779	1	0	1	0	1	1	4
OG0006780	1	2	1	0	0	0	4
OG0006781	1	0	1	0	1	1	4
OG0006782	1	0	1	0	0	2	4
OG0006783	2	0	1	0	0	1	4
OG0006784	1	0	0	1	1	1	4
OG0006785	1	0	1	0	1	1	4
OG0006786	1	1	1	0	0	1	4
OG0006787	1	0	1	0	1	1	4
OG0006788	1	0	1	1	1	0	4
OG0006789	1	0	1	1	1	0	4
OG0006790	1	0	1	0	1	1	4
OG0006791	1	0	1	0	1	1	4
OG0006792	1	1	1	0	1	0	4
OG0006793	4	0	0	0	0	0	4
OG0006794	2	1	0	0	0	1	4
OG0006795	1	1	1	1	0	0	4
OG0006796	2	1	0	0	1	0	4
OG0006797	1	0	1	0	1	1	4
OG0006798	1	0	1	0	1	1	4
OG0006799	1	0	1	1	1	0	4
OG0006800	1	0	1	1	1	0	4
OG0006801	3	0	1	0	0	0	4
OG0006802	1	0	1	0	1	1	4
OG0006803	1	1	1	1	0	0	4
OG0006804	1	0	1	1	1	0	4
OG0006805	1	0	1	1	0	1	4
OG0006806	1	0	1	0	1	1	4
OG0006807	2	0	1	0	0	1	4
OG0006808	1	1	1	0	1	0	4
OG0006809	1	0	1	0	1	1	4
OG0006810	1	1	1	0	1	0	4
OG0006811	1	0	1	1	1	0	4
OG0006812	1	0	1	1	1	0	4
OG0006813	1	0	1	0	1	1	4
OG0006814	1	0	1	0	1	1	4
OG0006815	2	0	1	1	0	0	4
OG0006816	1	1	1	0	1	0	4
OG0006817	1	0	1	1	0	1	4
OG0006818	1	1	1	0	1	0	4
OG0006819	1	1	1	0	0	1	4
OG0006820	1	1	1	0	1	0	4
OG0006821	1	2	0	1	0	0	4
OG0006822	1	0	1	0	1	1	4
OG0006823	1	0	1	0	1	1	4
OG0006824	1	0	1	0	1	1	4
OG0006825	1	0	1	0	1	1	4
OG0006826	1	0	1	0	1	1	4
OG0006827	1	1	1	1	0	0	4
OG0006828	1	0	1	1	0	1	4
OG0006829	1	1	1	1	0	0	4
OG0006830	1	0	1	1	1	0	4
OG0006831	1	0	1	0	1	1	4
OG0006832	1	1	1	1	0	0	4
OG0006833	2	0	1	1	0	0	4
OG0006834	1	1	1	0	1	0	4
OG0006835	1	0	1	1	1	0	4
OG0006836	1	0	1	0	1	1	4
OG0006837	1	1	1	1	0	0	4
OG0006838	1	0	1	0	1	1	4
OG0006839	1	1	0	0	1	1	4
OG0006840	1	1	0	1	0	1	4
OG0006841	1	0	1	1	1	0	4
OG0006842	1	0	1	0	1	1	4
OG0006843	1	1	1	0	1	0	4
OG0006844	1	0	1	0	1	1	4
OG0006845	1	1	1	0	0	1	4
OG0006846	1	0	1	1	0	1	4
OG0006847	1	0	1	0	1	1	4
OG0006848	1	0	1	1	0	1	4
OG0006849	4	0	0	0	0	0	4
OG0006850	1	1	1	0	1	0	4
OG0006851	1	0	1	0	1	1	4
OG0006852	1	1	1	0	1	0	4
OG0006853	1	0	1	1	0	1	4
OG0006854	1	1	0	1	1	0	4
OG0006855	1	1	1	0	1	0	4
OG0006856	1	0	1	0	1	1	4
OG0006857	1	1	1	1	0	0	4
OG0006858	1	1	1	0	0	1	4
OG0006859	1	0	1	0	1	1	4
OG0006860	1	0	1	1	0	1	4
OG0006861	1	0	1	1	1	0	4
OG0006862	1	1	1	0	1	0	4
OG0006863	1	0	1	1	0	1	4
OG0006864	1	0	1	1	1	0	4
OG0006865	1	0	1	1	1	0	4
OG0006866	1	0	1	1	1	0	4
OG0006867	1	0	1	1	1	0	4
OG0006868	1	1	1	1	0	0	4
OG0006869	1	1	1	0	0	1	4
OG0006870	1	0	2	0	0	1	4
OG0006871	1	3	0	0	0	0	4
OG0006872	1	0	1	0	1	1	4
OG0006873	1	1	1	0	0	1	4
OG0006874	1	1	1	0	1	0	4
OG0006875	1	0	1	0	1	1	4
OG0006876	1	1	1	1	0	0	4
OG0006877	1	0	1	1	1	0	4
OG0006878	1	0	1	1	1	0	4
OG0006879	1	0	1	1	1	0	4
OG0006880	1	0	1	1	1	0	4
OG0006881	1	0	1	2	0	0	4
OG0006882	1	0	1	0	1	1	4
OG0006883	1	1	1	1	0	0	4
OG0006884	1	1	1	0	1	0	4
OG0006885	1	0	1	0	1	1	4
OG0006886	1	0	1	0	1	1	4
OG0006887	2	1	1	0	0	0	4
OG0006888	1	0	1	1	0	1	4
OG0006889	1	0	1	0	0	2	4
OG0006890	1	1	1	1	0	0	4
OG0006891	1	0	1	0	1	1	4
OG0006892	1	0	1	0	1	1	4
OG0006893	1	0	1	1	0	1	4
OG0006894	1	0	1	0	1	1	4
OG0006895	2	2	0	0	0	0	4
OG0006896	1	0	1	1	0	1	4
OG0006897	1	0	1	1	1	0	4
OG0006898	2	0	1	0	0	1	4
OG0006899	1	0	1	0	2	0	4
OG0006900	1	0	1	0	1	1	4
OG0006901	1	0	1	1	1	0	4
OG0006902	1	1	1	0	1	0	4
OG0006903	1	0	1	0	1	1	4
OG0006904	1	1	0	1	1	0	4
OG0006905	1	0	1	0	1	1	4
OG0006906	3	0	1	0	0	0	4
OG0006907	1	1	1	0	0	1	4
OG0006908	1	1	1	0	1	0	4
OG0006909	1	0	1	1	0	1	4
OG0006910	1	1	1	1	0	0	4
OG0006911	1	1	1	0	1	0	4
OG0006912	1	0	1	0	1	1	4
OG0006913	1	1	1	0	0	1	4
OG0006914	1	0	1	1	1	0	4
OG0006915	1	1	0	0	1	1	4
OG0006916	1	0	1	0	1	1	4
OG0006917	3	1	0	0	0	0	4
OG0006918	1	0	1	0	1	1	4
OG0006919	1	0	1	1	0	1	4
OG0006920	1	1	0	0	0	2	4
OG0006921	1	2	0	1	0	0	4
OG0006922	1	1	1	0	0	1	4
OG0006923	1	2	1	0	0	0	4
OG0006924	1	1	1	1	0	0	4
OG0006925	1	0	1	0	1	1	4
OG0006926	1	0	1	0	2	0	4
OG0006927	1	0	1	0	1	1	4
OG0006928	1	0	1	1	0	1	4
OG0006929	1	0	1	1	1	0	4
OG0006930	1	0	1	1	0	1	4
OG0006931	1	0	0	1	0	2	4
OG0006932	1	0	1	0	1	1	4
OG0006933	1	1	1	1	0	0	4
OG0006934	1	0	1	0	1	1	4
OG0006935	1	0	1	1	1	0	4
OG0006936	1	1	1	0	1	0	4
OG0006937	1	0	1	1	0	1	4
OG0006938	1	0	1	1	0	1	4
OG0006939	1	0	1	1	0	1	4
OG0006940	1	0	1	1	1	0	4
OG0006941	1	1	1	0	1	0	4
OG0006942	1	0	1	1	1	0	4
OG0006943	1	0	1	1	0	1	4
OG0006944	1	1	1	0	1	0	4
OG0006945	1	0	1	0	2	0	4
OG0006946	1	0	1	0	1	1	4
OG0006947	1	1	1	0	0	1	4
OG0006948	1	0	1	1	1	0	4
OG0006949	1	0	1	1	0	1	4
OG0006950	1	1	1	1	0	0	4
OG0006951	1	0	1	0	1	1	4
OG0006952	1	0	1	1	1	0	4
OG0006953	1	0	1	1	1	0	4
OG0006954	1	2	0	0	0	1	4
OG0006955	1	1	0	0	1	1	4
OG0006956	1	1	1	1	0	0	4
OG0006957	1	0	1	0	2	0	4
OG0006958	1	0	1	0	1	1	4
OG0006959	1	0	1	1	1	0	4
OG0006960	1	1	1	1	0	0	4
OG0006961	1	1	1	0	1	0	4
OG0006962	1	1	1	0	1	0	4
OG0006963	1	0	1	1	1	0	4
OG0006964	1	0	1	1	1	0	4
OG0006965	1	0	1	1	1	0	4
OG0006966	1	0	1	1	0	1	4
OG0006967	1	0	1	1	0	1	4
OG0006968	1	0	1	0	1	1	4
OG0006969	2	0	1	1	0	0	4
OG0006970	1	0	1	0	0	2	4
OG0006971	2	0	1	0	1	0	4
OG0006972	2	1	0	1	0	0	4
OG0006973	1	0	1	0	1	1	4
OG0006974	1	0	0	1	1	1	4
OG0006975	1	1	1	0	1	0	4
OG0006976	1	0	1	1	0	1	4
OG0006977	1	0	1	0	1	1	4
OG0006978	1	0	1	1	1	0	4
OG0006979	1	0	1	0	1	1	4
OG0006980	1	0	1	1	0	1	4
OG0006981	1	1	1	1	0	0	4
OG0006982	1	0	1	1	1	0	4
OG0006983	1	0	1	1	0	1	4
OG0006984	1	0	1	0	1	1	4
OG0006985	1	0	1	1	1	0	4
OG0006986	1	1	1	1	0	0	4
OG0006987	2	1	0	1	0	0	4
OG0006988	1	0	1	1	1	0	4
OG0006989	1	0	1	1	1	0	4
OG0006990	1	1	0	0	1	1	4
OG0006991	1	1	1	0	0	1	4
OG0006992	1	0	1	1	1	0	4
OG0006993	1	1	1	0	0	1	4
OG0006994	1	0	1	1	0	1	4
OG0006995	1	0	1	1	1	0	4
OG0006996	1	0	1	1	0	1	4
OG0006997	1	0	1	1	0	1	4
OG0006998	1	1	1	1	0	0	4
OG0006999	1	1	1	1	0	0	4
OG0007000	1	1	1	1	0	0	4
OG0007001	1	1	1	1	0	0	4
OG0007002	1	0	1	2	0	0	4
OG0007003	1	0	1	0	1	1	4
OG0007004	1	0	1	1	0	1	4
OG0007005	1	0	1	1	1	0	4
OG0007006	1	0	1	0	1	1	4
OG0007007	1	0	1	1	0	1	4
OG0007008	1	0	1	1	1	0	4
OG0007009	1	1	1	0	0	1	4
OG0007010	1	0	1	1	1	0	4
OG0007011	1	1	1	0	1	0	4
OG0007012	1	0	1	0	1	1	4
OG0007013	1	0	1	0	1	1	4
OG0007014	1	0	1	0	1	1	4
OG0007015	1	0	0	1	1	1	4
OG0007016	1	1	1	0	1	0	4
OG0007017	1	1	1	1	0	0	4
OG0007018	1	0	1	1	1	0	4
OG0007019	1	1	1	0	1	0	4
OG0007020	1	0	1	1	1	0	4
OG0007021	1	0	1	0	1	1	4
OG0007022	1	0	1	1	1	0	4
OG0007023	1	0	1	1	1	0	4
OG0007024	1	0	1	0	2	0	4
OG0007025	1	0	1	1	0	1	4
OG0007026	1	1	1	0	0	1	4
OG0007027	2	1	0	1	0	0	4
OG0007028	1	0	1	0	1	1	4
OG0007029	1	1	1	1	0	0	4
OG0007030	1	0	1	1	1	0	4
OG0007031	1	0	1	1	1	0	4
OG0007032	1	0	1	1	1	0	4
OG0007033	1	1	1	0	0	1	4
OG0007034	1	1	1	0	1	0	4
OG0007035	1	0	1	0	1	1	4
OG0007036	1	0	1	0	1	1	4
OG0007037	1	0	1	0	1	1	4
OG0007038	1	1	0	1	1	0	4
OG0007039	1	1	1	0	1	0	4
OG0007040	1	0	1	0	2	0	4
OG0007041	1	0	1	0	1	1	4
OG0007042	1	0	1	0	1	1	4
OG0007043	1	1	1	1	0	0	4
OG0007044	1	0	1	1	1	0	4
OG0007045	1	0	1	1	0	1	4
OG0007046	1	0	1	1	0	1	4
OG0007047	1	0	1	1	0	1	4
OG0007048	1	1	1	0	0	1	4
OG0007049	2	0	1	1	0	0	4
OG0007050	2	0	1	0	0	1	4
OG0007051	1	0	1	1	0	1	4
OG0007052	1	0	1	1	1	0	4
OG0007053	2	0	0	2	0	0	4
OG0007054	1	1	1	1	0	0	4
OG0007055	1	0	1	1	0	1	4
OG0007056	1	1	1	0	0	1	4
OG0007057	1	0	1	1	1	0	4
OG0007058	1	0	1	2	0	0	4
OG0007059	1	0	1	0	1	1	4
OG0007060	1	0	1	0	1	1	4
OG0007061	1	1	1	0	1	0	4
OG0007062	1	0	1	0	0	2	4
OG0007063	1	0	1	1	0	1	4
OG0007064	1	1	1	0	1	0	4
OG0007065	1	0	1	1	1	0	4
OG0007066	1	0	1	1	1	0	4
OG0007067	1	1	1	0	0	1	4
OG0007068	1	0	1	1	0	1	4
OG0007069	1	0	1	0	1	1	4
OG0007070	1	1	1	1	0	0	4
OG0007071	1	1	0	1	1	0	4
OG0007072	1	0	1	1	1	0	4
OG0007073	1	0	1	1	1	0	4
OG0007074	1	1	1	0	1	0	4
OG0007075	1	1	1	0	1	0	4
OG0007076	1	0	1	1	1	0	4
OG0007077	1	0	1	1	0	1	4
OG0007078	1	0	1	1	1	0	4
OG0007079	1	0	1	1	0	1	4
OG0007080	1	0	1	1	0	1	4
OG0007081	1	0	1	1	0	1	4
OG0007082	1	1	1	1	0	0	4
OG0007083	1	0	0	0	1	2	4
OG0007084	1	1	1	0	1	0	4
OG0007085	2	1	1	0	0	0	4
OG0007086	1	1	1	0	0	1	4
OG0007087	1	1	1	0	0	1	4
OG0007088	1	1	1	1	0	0	4
OG0007089	1	0	1	1	1	0	4
OG0007090	1	0	1	0	1	1	4
OG0007091	1	0	1	1	0	1	4
OG0007092	1	1	1	1	0	0	4
OG0007093	1	0	1	1	0	1	4
OG0007094	4	0	0	0	0	0	4
OG0007095	1	0	1	1	1	0	4
OG0007096	3	0	1	0	0	0	4
OG0007097	1	1	1	1	0	0	4
OG0007098	1	2	1	0	0	0	4
OG0007099	1	0	1	1	1	0	4
OG0007100	1	0	0	3	0	0	4
OG0007101	4	0	0	0	0	0	4
OG0007102	1	0	0	1	1	1	4
OG0007103	1	1	1	0	1	0	4
OG0007104	1	0	1	1	0	1	4
OG0007105	1	0	1	0	1	1	4
OG0007106	1	0	1	0	1	1	4
OG0007107	1	1	0	1	0	1	4
OG0007108	1	0	1	1	0	1	4
OG0007109	1	0	1	1	1	0	4
OG0007110	1	1	1	0	1	0	4
OG0007111	1	0	1	0	1	1	4
OG0007112	1	0	1	1	0	1	4
OG0007113	1	1	1	0	0	1	4
OG0007114	1	0	1	0	1	1	4
OG0007115	1	1	1	0	0	1	4
OG0007116	1	0	1	1	0	1	4
OG0007117	1	0	1	1	0	1	4
OG0007118	1	1	1	1	0	0	4
OG0007119	1	0	1	1	0	1	4
OG0007120	1	0	1	0	1	1	4
OG0007121	1	0	1	1	0	1	4
OG0007122	1	0	1	1	1	0	4
OG0007123	1	0	1	0	1	1	4
OG0007124	1	0	0	1	1	1	4
OG0007125	1	0	1	1	1	0	4
OG0007126	1	0	1	1	0	1	4
OG0007127	1	0	1	2	0	0	4
OG0007128	1	0	1	1	0	1	4
OG0007129	1	0	1	1	1	0	4
OG0007130	1	0	1	1	0	1	4
OG0007131	1	2	1	0	0	0	4
OG0007132	1	0	1	1	1	0	4
OG0007133	1	1	1	1	0	0	4
OG0007134	1	1	1	0	1	0	4
OG0007135	1	0	1	1	1	0	4
OG0007136	1	0	1	1	1	0	4
OG0007137	1	0	0	1	0	2	4
OG0007138	1	0	1	1	0	1	4
OG0007139	1	0	1	0	1	1	4
OG0007140	1	1	1	0	0	1	4
OG0007141	1	1	1	1	0	0	4
OG0007142	1	0	1	1	1	0	4
OG0007143	1	1	1	1	0	0	4
OG0007144	1	1	0	1	1	0	4
OG0007145	1	0	1	0	1	1	4
OG0007146	1	0	0	1	1	1	4
OG0007147	1	0	0	2	0	1	4
OG0007148	1	1	1	1	0	0	4
OG0007149	1	0	1	1	0	1	4
OG0007150	1	2	0	1	0	0	4
OG0007151	1	1	1	1	0	0	4
OG0007152	1	0	1	1	0	1	4
OG0007153	1	0	1	0	1	1	4
OG0007154	1	0	1	1	0	1	4
OG0007155	1	0	0	1	1	1	4
OG0007156	1	0	1	1	1	0	4
OG0007157	1	1	0	1	1	0	4
OG0007158	1	0	1	1	1	0	4
OG0007159	1	1	1	0	0	1	4
OG0007160	1	0	1	0	1	1	4
OG0007161	1	0	1	0	1	1	4
OG0007162	1	0	1	0	1	1	4
OG0007163	1	0	1	1	1	0	4
OG0007164	1	1	1	1	0	0	4
OG0007165	1	0	1	1	1	0	4
OG0007166	1	0	1	1	1	0	4
OG0007167	1	1	1	0	1	0	4
OG0007168	1	0	1	0	1	1	4
OG0007169	1	0	1	1	1	0	4
OG0007170	1	0	1	1	1	0	4
OG0007171	1	1	0	1	1	0	4
OG0007172	1	1	0	2	0	0	4
OG0007173	1	1	1	1	0	0	4
OG0007174	1	0	1	1	1	0	4
OG0007175	1	1	1	0	0	1	4
OG0007176	1	1	1	1	0	0	4
OG0007177	1	0	1	1	1	0	4
OG0007178	1	2	0	1	0	0	4
OG0007179	1	0	1	0	1	1	4
OG0007180	1	0	1	0	1	1	4
OG0007181	1	1	1	0	0	1	4
OG0007182	1	0	1	0	2	0	4
OG0007183	1	1	1	0	1	0	4
OG0007184	1	0	0	1	1	1	4
OG0007185	1	1	1	1	0	0	4
OG0007186	1	0	1	1	0	1	4
OG0007187	1	1	1	0	1	0	4
OG0007188	1	0	1	2	0	0	4
OG0007189	1	1	1	0	1	0	4
OG0007190	1	0	1	1	0	1	4
OG0007191	1	0	0	1	1	1	4
OG0007192	1	0	0	1	1	1	4
OG0007193	1	0	1	1	1	0	4
OG0007194	1	0	1	1	1	0	4
OG0007195	1	1	1	1	0	0	4
OG0007196	1	1	1	0	0	1	4
OG0007197	1	1	1	0	1	0	4
OG0007198	1	0	1	1	0	1	4
OG0007199	1	1	1	0	0	1	4
OG0007200	1	0	1	1	0	1	4
OG0007201	1	0	1	0	1	1	4
OG0007202	1	0	1	0	1	1	4
OG0007203	1	1	2	0	0	0	4
OG0007204	1	1	1	0	0	1	4
OG0007205	1	0	1	0	0	2	4
OG0007206	1	0	1	1	1	0	4
OG0007207	1	1	0	1	0	1	4
OG0007208	1	0	1	1	1	0	4
OG0007209	1	0	1	1	1	0	4
OG0007210	1	0	1	0	1	1	4
OG0007211	1	0	1	1	0	1	4
OG0007212	1	1	0	1	0	1	4
OG0007213	1	0	1	1	0	1	4
OG0007214	1	0	1	1	0	1	4
OG0007215	1	0	1	0	1	1	4
OG0007216	1	1	1	0	0	1	4
OG0007217	1	1	1	0	1	0	4
OG0007218	2	0	1	0	0	1	4
OG0007219	1	1	0	2	0	0	4
OG0007220	1	0	1	1	0	1	4
OG0007221	1	1	1	1	0	0	4
OG0007222	1	0	1	1	0	1	4
OG0007223	1	0	1	1	1	0	4
OG0007224	1	0	1	1	0	1	4
OG0007225	1	0	1	1	1	0	4
OG0007226	2	0	1	1	0	0	4
OG0007227	1	1	1	0	0	1	4
OG0007228	1	0	1	1	0	1	4
OG0007229	1	1	1	0	0	1	4
OG0007230	1	0	1	1	1	0	4
OG0007231	1	1	1	1	0	0	4
OG0007232	1	0	1	1	1	0	4
OG0007233	1	0	1	1	1	0	4
OG0007234	1	0	1	1	1	0	4
OG0007235	1	1	1	1	0	0	4
OG0007236	1	0	1	1	1	0	4
OG0007237	1	0	1	0	0	2	4
OG0007238	1	1	1	0	1	0	4
OG0007239	1	0	1	0	1	1	4
OG0007240	1	0	1	0	1	1	4
OG0007241	1	0	1	0	1	1	4
OG0007242	1	0	1	0	1	1	4
OG0007243	1	0	1	1	0	1	4
OG0007244	1	0	1	0	1	1	4
OG0007245	1	1	1	1	0	0	4
OG0007246	1	1	1	0	1	0	4
OG0007247	1	0	1	1	0	1	4
OG0007248	1	0	1	1	0	1	4
OG0007249	1	1	0	1	0	1	4
OG0007250	1	1	1	0	1	0	4
OG0007251	1	0	1	1	1	0	4
OG0007252	1	0	1	0	1	1	4
OG0007253	1	0	2	0	1	0	4
OG0007254	1	0	1	1	1	0	4
OG0007255	1	0	1	1	1	0	4
OG0007256	1	1	1	1	0	0	4
OG0007257	1	0	1	1	1	0	4
OG0007258	1	1	1	1	0	0	4
OG0007259	1	1	1	1	0	0	4
OG0007260	1	0	1	0	1	1	4
OG0007261	1	1	1	0	0	1	4
OG0007262	1	0	1	0	1	1	4
OG0007263	1	1	0	1	1	0	4
OG0007264	1	1	1	0	0	1	4
OG0007265	1	0	1	0	1	1	4
OG0007266	1	1	1	0	0	1	4
OG0007267	1	0	2	0	0	1	4
OG0007268	1	0	1	0	1	1	4
OG0007269	1	0	1	0	1	1	4
OG0007270	1	0	1	1	0	1	4
OG0007271	1	1	1	0	1	0	4
OG0007272	1	0	1	0	1	1	4
OG0007273	1	0	1	1	1	0	4
OG0007274	1	1	1	1	0	0	4
OG0007275	1	0	1	1	1	0	4
OG0007276	1	0	1	0	1	1	4
OG0007277	1	0	1	1	1	0	4
OG0007278	1	2	1	0	0	0	4
OG0007279	1	0	1	0	0	2	4
OG0007280	1	0	1	1	0	1	4
OG0007281	1	0	1	1	1	0	4
OG0007282	1	1	1	1	0	0	4
OG0007283	1	1	0	0	1	1	4
OG0007284	1	0	1	0	1	1	4
OG0007285	1	0	1	0	1	1	4
OG0007286	1	1	1	0	1	0	4
OG0007287	1	0	1	1	1	0	4
OG0007288	1	0	1	1	1	0	4
OG0007289	1	0	1	0	1	1	4
OG0007290	1	0	1	0	1	1	4
OG0007291	1	1	1	1	0	0	4
OG0007292	1	0	1	1	1	0	4
OG0007293	1	1	1	1	0	0	4
OG0007294	0	1	1	0	1	1	4
OG0007295	0	1	1	0	1	1	4
OG0007296	0	1	1	0	1	1	4
OG0007297	0	2	0	0	2	0	4
OG0007298	0	1	1	1	1	0	4
OG0007299	0	1	1	1	1	0	4
OG0007300	0	1	1	0	1	1	4
OG0007301	0	2	1	0	0	1	4
OG0007302	0	2	1	1	0	0	4
OG0007303	0	1	1	0	1	1	4
OG0007304	0	1	1	0	1	1	4
OG0007305	0	1	1	0	1	1	4
OG0007306	0	1	1	1	1	0	4
OG0007307	0	1	1	1	1	0	4
OG0007308	0	1	1	1	0	1	4
OG0007309	0	2	1	0	1	0	4
OG0007310	0	1	1	1	0	1	4
OG0007311	0	1	1	0	1	1	4
OG0007312	0	1	1	1	1	0	4
OG0007313	0	4	0	0	0	0	4
OG0007314	0	1	1	0	1	1	4
OG0007315	0	1	1	1	1	0	4
OG0007316	0	1	1	1	0	1	4
OG0007317	0	1	1	0	1	1	4
OG0007318	0	1	1	0	1	1	4
OG0007319	0	3	0	1	0	0	4
OG0007320	0	1	1	1	0	1	4
OG0007321	0	1	1	0	1	1	4
OG0007322	0	1	1	1	0	1	4
OG0007323	0	2	1	0	1	0	4
OG0007324	0	1	1	1	0	1	4
OG0007325	0	1	1	0	1	1	4
OG0007326	0	1	1	0	1	1	4
OG0007327	0	1	1	0	1	1	4
OG0007328	0	1	1	1	1	0	4
OG0007329	0	1	0	1	1	1	4
OG0007330	0	1	1	1	0	1	4
OG0007331	0	1	1	1	1	0	4
OG0007332	0	1	1	1	0	1	4
OG0007333	0	1	1	0	0	2	4
OG0007334	0	1	1	1	1	0	4
OG0007335	0	1	1	0	1	1	4
OG0007336	0	1	1	0	1	1	4
OG0007337	0	1	1	1	1	0	4
OG0007338	0	1	1	1	0	1	4
OG0007339	0	1	1	1	1	0	4
OG0007340	0	1	1	1	1	0	4
OG0007341	0	1	1	0	1	1	4
OG0007342	0	1	1	1	1	0	4
OG0007343	0	1	1	1	1	0	4
OG0007344	0	1	1	1	0	1	4
OG0007345	0	1	1	1	0	1	4
OG0007346	0	1	1	1	0	1	4
OG0007347	0	1	1	1	0	1	4
OG0007348	0	1	1	1	0	1	4
OG0007349	0	1	1	0	1	1	4
OG0007350	0	1	1	1	0	1	4
OG0007351	0	1	1	0	1	1	4
OG0007352	0	1	1	1	1	0	4
OG0007353	0	1	1	1	0	1	4
OG0007354	0	2	0	1	1	0	4
OG0007355	0	2	1	1	0	0	4
OG0007356	0	2	1	0	1	0	4
OG0007357	0	1	1	0	1	1	4
OG0007358	0	1	1	0	1	1	4
OG0007359	0	1	1	0	1	1	4
OG0007360	0	2	1	0	1	0	4
OG0007361	0	1	1	0	1	1	4
OG0007362	0	1	1	1	0	1	4
OG0007363	0	1	1	1	1	0	4
OG0007364	0	1	1	1	1	0	4
OG0007365	0	2	0	0	0	2	4
OG0007366	0	1	1	0	1	1	4
OG0007367	0	1	1	1	0	1	4
OG0007368	0	3	1	0	0	0	4
OG0007369	0	1	1	1	0	1	4
OG0007370	0	1	1	1	1	0	4
OG0007371	0	1	1	0	1	1	4
OG0007372	0	1	1	0	2	0	4
OG0007373	0	1	1	0	1	1	4
OG0007374	0	1	1	1	0	1	4
OG0007375	0	1	1	0	1	1	4
OG0007376	0	1	1	1	0	1	4
OG0007377	0	1	1	1	0	1	4
OG0007378	0	1	0	1	1	1	4
OG0007379	0	1	1	0	2	0	4
OG0007380	0	1	1	1	0	1	4
OG0007381	0	1	1	1	1	0	4
OG0007382	0	2	1	0	1	0	4
OG0007383	0	1	1	2	0	0	4
OG0007384	0	1	1	0	1	1	4
OG0007385	0	1	1	0	1	1	4
OG0007386	0	2	0	2	0	0	4
OG0007387	0	1	1	1	1	0	4
OG0007388	0	1	1	0	1	1	4
OG0007389	0	1	1	1	1	0	4
OG0007390	0	1	1	1	0	1	4
OG0007391	0	1	1	1	1	0	4
OG0007392	0	1	1	0	1	1	4
OG0007393	0	1	1	0	1	1	4
OG0007394	0	1	1	1	1	0	4
OG0007395	0	4	0	0	0	0	4
OG0007396	0	1	1	1	1	0	4
OG0007397	0	1	1	1	0	1	4
OG0007398	0	1	1	0	1	1	4
OG0007399	0	1	1	1	1	0	4
OG0007400	0	2	1	0	0	1	4
OG0007401	0	1	1	0	1	1	4
OG0007402	0	1	1	0	1	1	4
OG0007403	0	1	2	0	1	0	4
OG0007404	0	2	1	0	0	1	4
OG0007405	0	1	1	0	1	1	4
OG0007406	0	1	0	1	1	1	4
OG0007407	0	1	1	0	1	1	4
OG0007408	0	1	1	1	1	0	4
OG0007409	0	1	1	0	1	1	4
OG0007410	0	1	1	1	1	0	4
OG0007411	0	1	1	2	0	0	4
OG0007412	0	1	1	0	1	1	4
OG0007413	0	1	1	1	0	1	4
OG0007414	0	1	1	1	1	0	4
OG0007415	0	1	1	0	1	1	4
OG0007416	0	1	1	0	1	1	4
OG0007417	0	1	1	1	0	1	4
OG0007418	0	2	1	1	0	0	4
OG0007419	0	1	1	1	1	0	4
OG0007420	0	1	1	1	1	0	4
OG0007421	0	1	1	0	1	1	4
OG0007422	0	1	1	0	1	1	4
OG0007423	0	1	1	1	0	1	4
OG0007424	0	1	1	1	0	1	4
OG0007425	0	4	0	0	0	0	4
OG0007426	0	1	1	0	1	1	4
OG0007427	0	1	1	1	0	1	4
OG0007428	0	2	1	0	1	0	4
OG0007429	0	1	1	0	2	0	4
OG0007430	0	1	1	0	1	1	4
OG0007431	0	1	1	1	1	0	4
OG0007432	0	1	1	0	1	1	4
OG0007433	0	1	1	0	1	1	4
OG0007434	0	2	1	0	0	1	4
OG0007435	0	1	1	0	1	1	4
OG0007436	0	1	1	2	0	0	4
OG0007437	0	1	1	0	1	1	4
OG0007438	0	1	1	0	1	1	4
OG0007439	0	1	1	0	1	1	4
OG0007440	0	1	0	1	1	1	4
OG0007441	0	1	1	0	1	1	4
OG0007442	0	1	1	1	1	0	4
OG0007443	0	1	1	1	1	0	4
OG0007444	0	1	1	1	0	1	4
OG0007445	0	1	1	0	1	1	4
OG0007446	0	1	1	1	1	0	4
OG0007447	0	1	1	1	1	0	4
OG0007448	0	1	1	2	0	0	4
OG0007449	0	1	1	0	1	1	4
OG0007450	0	1	1	1	0	1	4
OG0007451	0	1	1	1	1	0	4
OG0007452	0	1	0	1	1	1	4
OG0007453	0	1	1	1	0	1	4
OG0007454	0	1	1	1	1	0	4
OG0007455	0	1	1	1	0	1	4
OG0007456	0	2	1	1	0	0	4
OG0007457	0	1	1	1	1	0	4
OG0007458	0	1	1	0	0	2	4
OG0007459	0	1	1	0	2	0	4
OG0007460	0	2	0	0	1	1	4
OG0007461	0	1	1	0	1	1	4
OG0007462	0	2	1	0	0	1	4
OG0007463	0	1	1	0	1	1	4
OG0007464	0	3	1	0	0	0	4
OG0007465	0	1	1	1	1	0	4
OG0007466	0	2	1	0	0	1	4
OG0007467	0	1	1	1	1	0	4
OG0007468	0	2	1	0	1	0	4
OG0007469	0	1	1	1	1	0	4
OG0007470	0	1	1	0	1	1	4
OG0007471	0	2	1	0	1	0	4
OG0007472	0	1	1	0	1	1	4
OG0007473	0	1	1	0	1	1	4
OG0007474	0	1	1	1	1	0	4
OG0007475	0	1	1	0	1	1	4
OG0007476	0	1	1	1	1	0	4
OG0007477	0	1	1	0	1	1	4
OG0007478	0	2	1	0	0	1	4
OG0007479	0	1	0	1	1	1	4
OG0007480	0	1	1	1	1	0	4
OG0007481	0	1	1	1	0	1	4
OG0007482	0	1	1	1	1	0	4
OG0007483	0	1	1	0	1	1	4
OG0007484	0	1	1	1	1	0	4
OG0007485	0	1	0	1	1	1	4
OG0007486	0	1	1	1	1	0	4
OG0007487	0	1	1	1	1	0	4
OG0007488	0	1	1	1	1	0	4
OG0007489	0	1	2	1	0	0	4
OG0007490	0	1	1	0	1	1	4
OG0007491	0	1	1	0	1	1	4
OG0007492	0	2	0	0	2	0	4
OG0007493	0	2	0	1	0	1	4
OG0007494	0	1	1	1	0	1	4
OG0007495	0	1	1	0	1	1	4
OG0007496	0	1	1	0	1	1	4
OG0007497	0	1	1	1	0	1	4
OG0007498	0	1	1	1	1	0	4
OG0007499	0	1	1	0	1	1	4
OG0007500	0	1	1	0	1	1	4
OG0007501	0	1	1	0	1	1	4
OG0007502	0	1	1	1	1	0	4
OG0007503	0	2	1	0	0	1	4
OG0007504	0	2	1	1	0	0	4
OG0007505	0	1	0	1	1	1	4
OG0007506	0	1	1	1	1	0	4
OG0007507	0	1	1	0	1	1	4
OG0007508	0	1	1	0	1	1	4
OG0007509	0	2	0	0	0	2	4
OG0007510	0	1	1	0	2	0	4
OG0007511	0	1	1	0	2	0	4
OG0007512	0	1	1	2	0	0	4
OG0007513	0	1	0	1	2	0	4
OG0007514	0	1	1	0	1	1	4
OG0007515	0	1	0	1	1	1	4
OG0007516	0	1	0	1	1	1	4
OG0007517	0	1	1	1	1	0	4
OG0007518	0	1	1	2	0	0	4
OG0007519	0	1	1	1	1	0	4
OG0007520	0	1	0	3	0	0	4
OG0007521	0	1	1	1	1	0	4
OG0007522	0	1	1	1	1	0	4
OG0007523	0	1	1	1	0	1	4
OG0007524	0	1	1	0	1	1	4
OG0007525	0	1	1	1	1	0	4
OG0007526	0	1	1	1	1	0	4
OG0007527	0	1	1	2	0	0	4
OG0007528	0	1	1	1	0	1	4
OG0007529	0	1	1	1	1	0	4
OG0007530	0	1	1	1	0	1	4
OG0007531	0	1	1	0	1	1	4
OG0007532	0	1	1	0	1	1	4
OG0007533	0	1	1	0	1	1	4
OG0007534	0	1	1	1	0	1	4
OG0007535	0	1	1	1	1	0	4
OG0007536	0	1	1	0	1	1	4
OG0007537	0	1	1	0	1	1	4
OG0007538	0	1	1	1	1	0	4
OG0007539	0	1	1	1	0	1	4
OG0007540	0	1	1	0	1	1	4
OG0007541	0	0	1	0	1	2	4
OG0007542	0	0	1	2	1	0	4
OG0007543	0	0	1	1	1	1	4
OG0007544	0	0	1	1	1	1	4
OG0007545	0	0	1	2	0	1	4
OG0007546	0	0	1	0	3	0	4
OG0007547	0	0	4	0	0	0	4
OG0007548	0	0	1	1	0	2	4
OG0007549	0	0	1	1	1	1	4
OG0007550	0	0	1	0	2	1	4
OG0007551	0	0	1	0	1	2	4
OG0007552	0	0	1	1	1	1	4
OG0007553	0	0	1	0	2	1	4
OG0007554	0	0	4	0	0	0	4
OG0007555	0	0	1	1	1	1	4
OG0007556	0	0	1	0	1	2	4
OG0007557	0	0	1	1	2	0	4
OG0007558	0	0	1	1	1	1	4
OG0007559	0	0	1	1	1	1	4
OG0007560	0	0	1	1	1	1	4
OG0007561	0	0	1	1	1	1	4
OG0007562	0	0	1	1	1	1	4
OG0007563	0	0	1	1	1	1	4
OG0007564	0	0	1	1	1	1	4
OG0007565	0	0	1	0	1	2	4
OG0007566	0	0	1	2	1	0	4
OG0007567	0	0	1	0	2	1	4
OG0007568	0	0	1	0	1	2	4
OG0007569	0	0	1	1	1	1	4
OG0007570	0	0	1	1	1	1	4
OG0007571	0	0	1	2	1	0	4
OG0007572	0	0	1	0	2	1	4
OG0007573	0	0	1	1	1	1	4
OG0007574	0	0	1	1	1	1	4
OG0007575	0	0	1	1	1	1	4
OG0007576	0	0	1	0	1	2	4
OG0007577	0	0	1	2	1	0	4
OG0007578	0	0	1	1	1	1	4
OG0007579	0	0	1	1	1	1	4
OG0007580	0	0	1	0	1	2	4
OG0007581	0	0	2	1	0	1	4
OG0007582	0	0	1	1	1	1	4
OG0007583	0	0	1	1	2	0	4
OG0007584	0	0	1	1	1	1	4
OG0007585	0	0	1	1	1	1	4
OG0007586	0	0	1	1	1	1	4
OG0007587	0	0	1	1	1	1	4
OG0007588	0	0	1	1	1	1	4
OG0007589	0	0	1	1	1	1	4
OG0007590	0	0	1	1	1	1	4
OG0007591	0	0	4	0	0	0	4
OG0007592	0	0	1	1	1	1	4
OG0007593	0	0	1	0	1	2	4
OG0007594	0	0	2	1	0	1	4
OG0007595	0	0	2	0	1	1	4
OG0007596	0	0	1	1	2	0	4
OG0007597	0	0	1	1	1	1	4
OG0007598	0	0	1	1	1	1	4
OG0007599	0	0	1	1	0	2	4
OG0007600	0	0	1	1	1	1	4
OG0007601	0	0	1	2	0	1	4
OG0007602	0	0	1	1	1	1	4
OG0007603	0	0	2	0	1	1	4
OG0007604	0	0	1	1	1	1	4
OG0007605	0	0	1	1	0	2	4
OG0007606	0	0	1	1	1	1	4
OG0007607	0	0	1	0	1	2	4
OG0007608	0	0	1	1	1	1	4
OG0007609	0	0	1	2	1	0	4
OG0007610	0	0	3	0	1	0	4
OG0007611	0	0	1	1	1	1	4
OG0007612	0	0	1	1	1	1	4
OG0007613	0	0	1	1	1	1	4
OG0007614	0	0	2	1	1	0	4
OG0007615	0	0	1	0	1	2	4
OG0007616	0	0	1	2	1	0	4
OG0007617	0	0	4	0	0	0	4
OG0007618	0	0	2	0	1	1	4
OG0007619	0	0	1	1	1	1	4
OG0007620	0	0	1	1	1	1	4
OG0007621	0	0	1	1	1	1	4
OG0007622	0	0	1	1	1	1	4
OG0007623	0	0	1	1	1	1	4
OG0007624	0	0	1	1	1	1	4
OG0007625	0	0	1	0	1	2	4
OG0007626	0	0	1	1	1	1	4
OG0007627	0	0	1	1	1	1	4
OG0007628	0	0	1	1	1	1	4
OG0007629	0	0	1	0	2	1	4
OG0007630	0	0	1	1	1	1	4
OG0007631	0	0	4	0	0	0	4
OG0007632	0	0	1	1	1	1	4
OG0007633	0	0	1	1	2	0	4
OG0007634	0	0	1	0	1	2	4
OG0007635	0	0	1	1	1	1	4
OG0007636	0	0	1	1	1	1	4
OG0007637	0	0	1	1	1	1	4
OG0007638	0	0	1	1	1	1	4
OG0007639	0	0	1	1	1	1	4
OG0007640	0	0	1	1	1	1	4
OG0007641	0	0	4	0	0	0	4
OG0007642	0	0	1	1	1	1	4
OG0007643	0	0	1	1	1	1	4
OG0007644	0	0	1	1	1	1	4
OG0007645	0	0	1	1	1	1	4
OG0007646	0	0	1	1	0	2	4
OG0007647	0	0	1	0	1	2	4
OG0007648	0	0	1	0	1	2	4
OG0007649	0	0	4	0	0	0	4
OG0007650	0	0	1	1	1	1	4
OG0007651	0	0	1	0	2	1	4
OG0007652	0	0	1	1	1	1	4
OG0007653	0	0	1	1	1	1	4
OG0007654	0	0	1	1	1	1	4
OG0007655	0	0	1	1	1	1	4
OG0007656	0	0	1	0	1	2	4
OG0007657	0	0	1	1	1	1	4
OG0007658	0	0	1	1	1	1	4
OG0007659	0	0	1	1	0	2	4
OG0007660	0	0	1	1	2	0	4
OG0007661	0	0	2	1	1	0	4
OG0007662	0	0	1	2	0	1	4
OG0007663	0	0	1	1	1	1	4
OG0007664	0	0	1	1	1	1	4
OG0007665	0	0	1	1	1	1	4
OG0007666	0	0	1	1	1	1	4
OG0007667	0	0	3	0	0	1	4
OG0007668	0	0	1	1	1	1	4
OG0007669	0	0	1	1	1	1	4
OG0007670	0	0	1	1	1	1	4
OG0007671	0	0	1	2	1	0	4
OG0007672	0	0	1	1	1	1	4
OG0007673	0	0	1	0	2	1	4
OG0007674	0	0	1	1	1	1	4
OG0007675	0	0	1	1	1	1	4
OG0007676	0	0	1	0	2	1	4
OG0007677	0	0	1	1	1	1	4
OG0007678	0	0	1	1	2	0	4
OG0007679	0	0	1	1	1	1	4
OG0007680	0	0	1	1	1	1	4
OG0007681	0	0	1	1	1	1	4
OG0007682	0	0	1	2	1	0	4
OG0007683	0	0	1	1	0	2	4
OG0007684	0	0	1	1	0	2	4
OG0007685	0	0	1	3	0	0	4
OG0007686	0	0	1	1	1	1	4
OG0007687	0	0	1	1	1	1	4
OG0007688	0	0	1	1	1	1	4
OG0007689	0	0	1	1	1	1	4
OG0007690	0	0	1	1	2	0	4
OG0007691	0	0	1	0	1	2	4
OG0007692	0	0	1	1	1	1	4
OG0007693	0	0	1	1	2	0	4
OG0007694	0	0	1	1	1	1	4
OG0007695	0	0	1	2	1	0	4
OG0007696	0	0	1	0	2	1	4
OG0007697	0	0	1	1	1	1	4
OG0007698	0	0	1	0	1	2	4
OG0007699	0	0	1	1	2	0	4
OG0007700	0	0	1	1	1	1	4
OG0007701	0	0	1	1	1	1	4
OG0007702	0	0	1	3	0	0	4
OG0007703	0	0	1	0	3	0	4
OG0007704	0	0	1	0	2	1	4
OG0007705	0	0	1	2	0	1	4
OG0007706	0	0	1	1	1	1	4
OG0007707	0	0	1	1	1	1	4
OG0007708	0	0	1	1	1	1	4
OG0007709	0	0	1	1	1	1	4
OG0007710	0	0	1	1	1	1	4
OG0007711	0	0	1	1	1	1	4
OG0007712	0	0	1	1	1	1	4
OG0007713	0	0	1	1	2	0	4
OG0007714	0	0	1	0	2	1	4
OG0007715	0	0	1	0	1	2	4
OG0007716	0	0	1	2	1	0	4
OG0007717	0	0	1	2	1	0	4
OG0007718	0	0	3	1	0	0	4
OG0007719	0	0	1	1	1	1	4
OG0007720	0	0	1	1	1	1	4
OG0007721	0	0	1	1	1	1	4
OG0007722	0	0	4	0	0	0	4
OG0007723	0	0	1	1	2	0	4
OG0007724	0	0	1	0	2	1	4
OG0007725	0	0	1	0	3	0	4
OG0007726	0	0	1	1	1	1	4
OG0007727	0	0	1	1	1	1	4
OG0007728	0	0	1	1	1	1	4
OG0007729	0	0	2	1	0	1	4
OG0007730	0	0	1	0	1	2	4
OG0007731	0	0	1	2	1	0	4
OG0007732	0	0	1	1	1	1	4
OG0007733	0	0	1	1	2	0	4
OG0007734	0	0	1	0	3	0	4
OG0007735	0	0	1	1	1	1	4
OG0007736	0	0	1	1	1	1	4
OG0007737	0	0	1	1	1	1	4
OG0007738	0	0	1	1	1	1	4
OG0007739	0	0	1	1	1	1	4
OG0007740	0	0	1	1	1	1	4
OG0007741	0	0	1	2	1	0	4
OG0007742	0	0	1	1	1	1	4
OG0007743	0	0	1	1	1	1	4
OG0007744	0	0	1	1	1	1	4
OG0007745	0	0	1	1	1	1	4
OG0007746	0	0	1	0	0	3	4
OG0007747	0	0	1	0	1	2	4
OG0007748	0	0	1	1	1	1	4
OG0007749	0	0	1	1	1	1	4
OG0007750	0	0	1	2	1	0	4
OG0007751	0	0	1	1	1	1	4
OG0007752	0	0	1	1	1	1	4
OG0007753	0	0	1	2	1	0	4
OG0007754	0	0	1	1	1	1	4
OG0007755	0	0	1	1	1	1	4
OG0007756	0	0	1	1	1	1	4
OG0007757	0	0	1	1	1	1	4
OG0007758	0	0	1	1	1	1	4
OG0007759	0	0	1	2	1	0	4
OG0007760	0	0	1	1	1	1	4
OG0007761	0	0	1	1	1	1	4
OG0007762	0	0	1	1	0	2	4
OG0007763	0	0	1	1	1	1	4
OG0007764	0	0	1	1	2	0	4
OG0007765	0	0	1	1	1	1	4
OG0007766	0	0	1	1	1	1	4
OG0007767	0	0	1	1	1	1	4
OG0007768	0	0	1	0	0	3	4
OG0007769	0	0	1	1	1	1	4
OG0007770	0	0	1	1	1	1	4
OG0007771	0	0	1	2	1	0	4
OG0007772	0	0	0	4	0	0	4
OG0007773	0	0	0	1	2	1	4
OG0007774	0	0	0	2	1	1	4
OG0007775	0	0	0	2	1	1	4
OG0007776	0	0	0	1	2	1	4
OG0007777	0	0	0	4	0	0	4
OG0007778	0	0	0	4	0	0	4
OG0007779	0	0	0	4	0	0	4
OG0007780	0	0	0	2	1	1	4
OG0007781	0	0	0	3	1	0	4
OG0007782	0	0	0	0	4	0	4
OG0007783	0	0	0	0	3	1	4
OG0007784	0	0	0	0	3	1	4
OG0007785	0	0	0	0	1	3	4
OG0007786	0	0	0	0	4	0	4
OG0007787	0	0	0	0	1	3	4
OG0007788	0	0	0	0	2	2	4
OG0007789	0	0	0	0	0	4	4
OG0007790	0	0	0	0	0	4	4
OG0007791	1	0	0	0	1	1	3
OG0007792	1	1	0	0	0	1	3
OG0007793	1	0	1	0	0	1	3
OG0007794	3	0	0	0	0	0	3
OG0007795	3	0	0	0	0	0	3
OG0007796	1	0	1	0	1	0	3
OG0007797	3	0	0	0	0	0	3
OG0007798	1	1	1	0	0	0	3
OG0007799	1	0	1	1	0	0	3
OG0007800	1	0	0	1	0	1	3
OG0007801	2	0	1	0	0	0	3
OG0007802	3	0	0	0	0	0	3
OG0007803	3	0	0	0	0	0	3
OG0007804	1	1	0	0	0	1	3
OG0007805	1	0	1	0	0	1	3
OG0007806	1	1	1	0	0	0	3
OG0007807	1	0	1	1	0	0	3
OG0007808	3	0	0	0	0	0	3
OG0007809	3	0	0	0	0	0	3
OG0007810	1	0	1	0	0	1	3
OG0007811	1	0	1	0	0	1	3
OG0007812	1	0	0	0	1	1	3
OG0007813	1	0	1	0	1	0	3
OG0007814	3	0	0	0	0	0	3
OG0007815	3	0	0	0	0	0	3
OG0007816	1	0	1	0	1	0	3
OG0007817	1	1	1	0	0	0	3
OG0007818	3	0	0	0	0	0	3
OG0007819	3	0	0	0	0	0	3
OG0007820	1	0	0	1	1	0	3
OG0007821	1	0	1	0	1	0	3
OG0007822	1	0	1	0	1	0	3
OG0007823	3	0	0	0	0	0	3
OG0007824	2	0	1	0	0	0	3
OG0007825	1	0	1	0	1	0	3
OG0007826	2	0	1	0	0	0	3
OG0007827	3	0	0	0	0	0	3
OG0007828	3	0	0	0	0	0	3
OG0007829	3	0	0	0	0	0	3
OG0007830	3	0	0	0	0	0	3
OG0007831	2	0	1	0	0	0	3
OG0007832	1	0	0	0	1	1	3
OG0007833	1	1	1	0	0	0	3
OG0007834	3	0	0	0	0	0	3
OG0007835	3	0	0	0	0	0	3
OG0007836	1	0	0	0	1	1	3
OG0007837	1	1	1	0	0	0	3
OG0007838	3	0	0	0	0	0	3
OG0007839	3	0	0	0	0	0	3
OG0007840	1	0	1	1	0	0	3
OG0007841	2	0	1	0	0	0	3
OG0007842	3	0	0	0	0	0	3
OG0007843	2	1	0	0	0	0	3
OG0007844	2	0	0	1	0	0	3
OG0007845	1	0	1	0	1	0	3
OG0007846	1	0	1	0	0	1	3
OG0007847	1	0	1	1	0	0	3
OG0007848	1	0	1	0	0	1	3
OG0007849	2	0	0	1	0	0	3
OG0007850	1	1	1	0	0	0	3
OG0007851	3	0	0	0	0	0	3
OG0007852	1	0	1	0	1	0	3
OG0007853	3	0	0	0	0	0	3
OG0007854	1	0	1	0	0	1	3
OG0007855	3	0	0	0	0	0	3
OG0007856	1	0	1	1	0	0	3
OG0007857	2	0	1	0	0	0	3
OG0007858	1	0	1	1	0	0	3
OG0007859	1	2	0	0	0	0	3
OG0007860	3	0	0	0	0	0	3
OG0007861	3	0	0	0	0	0	3
OG0007862	2	0	1	0	0	0	3
OG0007863	3	0	0	0	0	0	3
OG0007864	3	0	0	0	0	0	3
OG0007865	3	0	0	0	0	0	3
OG0007866	3	0	0	0	0	0	3
OG0007867	1	0	1	0	1	0	3
OG0007868	1	0	1	1	0	0	3
OG0007869	1	0	1	1	0	0	3
OG0007870	1	1	0	1	0	0	3
OG0007871	1	0	1	0	0	1	3
OG0007872	1	1	0	0	0	1	3
OG0007873	1	0	1	1	0	0	3
OG0007874	3	0	0	0	0	0	3
OG0007875	1	0	1	0	0	1	3
OG0007876	1	0	1	0	1	0	3
OG0007877	1	0	1	1	0	0	3
OG0007878	2	1	0	0	0	0	3
OG0007879	1	0	0	1	1	0	3
OG0007880	3	0	0	0	0	0	3
OG0007881	2	0	0	0	1	0	3
OG0007882	1	0	1	0	0	1	3
OG0007883	1	0	1	0	0	1	3
OG0007884	1	0	1	0	0	1	3
OG0007885	1	0	1	1	0	0	3
OG0007886	1	2	0	0	0	0	3
OG0007887	3	0	0	0	0	0	3
OG0007888	3	0	0	0	0	0	3
OG0007889	1	0	1	1	0	0	3
OG0007890	3	0	0	0	0	0	3
OG0007891	1	1	1	0	0	0	3
OG0007892	1	0	1	1	0	0	3
OG0007893	1	0	1	0	1	0	3
OG0007894	2	0	1	0	0	0	3
OG0007895	2	0	1	0	0	0	3
OG0007896	1	1	0	0	0	1	3
OG0007897	2	0	0	0	0	1	3
OG0007898	1	0	1	0	1	0	3
OG0007899	3	0	0	0	0	0	3
OG0007900	2	1	0	0	0	0	3
OG0007901	3	0	0	0	0	0	3
OG0007902	3	0	0	0	0	0	3
OG0007903	1	0	1	1	0	0	3
OG0007904	2	0	1	0	0	0	3
OG0007905	2	0	1	0	0	0	3
OG0007906	2	0	0	1	0	0	3
OG0007907	1	0	1	0	0	1	3
OG0007908	3	0	0	0	0	0	3
OG0007909	3	0	0	0	0	0	3
OG0007910	3	0	0	0	0	0	3
OG0007911	3	0	0	0	0	0	3
OG0007912	3	0	0	0	0	0	3
OG0007913	1	0	1	0	0	1	3
OG0007914	1	1	1	0	0	0	3
OG0007915	1	0	0	1	1	0	3
OG0007916	1	0	1	0	1	0	3
OG0007917	3	0	0	0	0	0	3
OG0007918	1	0	1	0	1	0	3
OG0007919	1	0	0	1	0	1	3
OG0007920	1	0	0	2	0	0	3
OG0007921	1	0	1	0	1	0	3
OG0007922	1	0	0	0	1	1	3
OG0007923	1	0	1	0	0	1	3
OG0007924	1	0	1	1	0	0	3
OG0007925	1	1	1	0	0	0	3
OG0007926	1	0	1	0	1	0	3
OG0007927	1	0	1	0	0	1	3
OG0007928	1	2	0	0	0	0	3
OG0007929	1	0	1	1	0	0	3
OG0007930	1	0	1	1	0	0	3
OG0007931	1	0	1	1	0	0	3
OG0007932	1	0	1	1	0	0	3
OG0007933	2	0	0	1	0	0	3
OG0007934	2	0	1	0	0	0	3
OG0007935	1	0	1	1	0	0	3
OG0007936	1	0	0	1	0	1	3
OG0007937	1	0	0	0	1	1	3
OG0007938	3	0	0	0	0	0	3
OG0007939	3	0	0	0	0	0	3
OG0007940	3	0	0	0	0	0	3
OG0007941	1	0	1	0	0	1	3
OG0007942	1	0	1	0	1	0	3
OG0007943	1	0	0	1	1	0	3
OG0007944	1	1	0	1	0	0	3
OG0007945	1	0	1	0	1	0	3
OG0007946	2	1	0	0	0	0	3
OG0007947	3	0	0	0	0	0	3
OG0007948	2	0	1	0	0	0	3
OG0007949	3	0	0	0	0	0	3
OG0007950	1	0	0	1	0	1	3
OG0007951	3	0	0	0	0	0	3
OG0007952	1	1	1	0	0	0	3
OG0007953	1	0	1	0	0	1	3
OG0007954	3	0	0	0	0	0	3
OG0007955	3	0	0	0	0	0	3
OG0007956	2	0	1	0	0	0	3
OG0007957	1	0	1	0	0	1	3
OG0007958	1	0	1	1	0	0	3
OG0007959	1	0	1	0	1	0	3
OG0007960	2	0	1	0	0	0	3
OG0007961	1	0	0	1	0	1	3
OG0007962	1	0	1	0	1	0	3
OG0007963	2	0	0	1	0	0	3
OG0007964	1	0	1	0	1	0	3
OG0007965	3	0	0	0	0	0	3
OG0007966	1	0	1	0	0	1	3
OG0007967	3	0	0	0	0	0	3
OG0007968	1	0	1	0	1	0	3
OG0007969	1	0	1	0	1	0	3
OG0007970	3	0	0	0	0	0	3
OG0007971	3	0	0	0	0	0	3
OG0007972	1	1	1	0	0	0	3
OG0007973	1	0	1	1	0	0	3
OG0007974	3	0	0	0	0	0	3
OG0007975	1	1	1	0	0	0	3
OG0007976	1	0	1	0	0	1	3
OG0007977	1	0	1	1	0	0	3
OG0007978	1	2	0	0	0	0	3
OG0007979	1	0	1	0	1	0	3
OG0007980	1	0	1	0	1	0	3
OG0007981	1	0	1	0	0	1	3
OG0007982	1	0	1	0	1	0	3
OG0007983	3	0	0	0	0	0	3
OG0007984	3	0	0	0	0	0	3
OG0007985	1	0	1	0	1	0	3
OG0007986	3	0	0	0	0	0	3
OG0007987	2	1	0	0	0	0	3
OG0007988	1	0	1	1	0	0	3
OG0007989	1	0	1	0	1	0	3
OG0007990	1	0	1	0	1	0	3
OG0007991	3	0	0	0	0	0	3
OG0007992	1	0	0	1	1	0	3
OG0007993	3	0	0	0	0	0	3
OG0007994	1	1	0	1	0	0	3
OG0007995	3	0	0	0	0	0	3
OG0007996	3	0	0	0	0	0	3
OG0007997	3	0	0	0	0	0	3
OG0007998	2	0	1	0	0	0	3
OG0007999	3	0	0	0	0	0	3
OG0008000	3	0	0	0	0	0	3
OG0008001	1	0	1	0	0	1	3
OG0008002	1	0	1	0	1	0	3
OG0008003	1	0	1	0	1	0	3
OG0008004	1	0	1	1	0	0	3
OG0008005	2	0	0	0	0	1	3
OG0008006	3	0	0	0	0	0	3
OG0008007	3	0	0	0	0	0	3
OG0008008	1	0	1	0	0	1	3
OG0008009	1	0	0	1	0	1	3
OG0008010	2	0	0	0	0	1	3
OG0008011	1	1	1	0	0	0	3
OG0008012	1	2	0	0	0	0	3
OG0008013	1	0	1	1	0	0	3
OG0008014	1	0	0	0	1	1	3
OG0008015	1	0	1	0	1	0	3
OG0008016	2	0	0	1	0	0	3
OG0008017	1	0	1	1	0	0	3
OG0008018	1	0	1	0	1	0	3
OG0008019	3	0	0	0	0	0	3
OG0008020	3	0	0	0	0	0	3
OG0008021	1	0	1	1	0	0	3
OG0008022	1	0	0	1	0	1	3
OG0008023	1	0	0	1	0	1	3
OG0008024	1	1	0	0	0	1	3
OG0008025	1	0	1	0	1	0	3
OG0008026	1	0	1	0	0	1	3
OG0008027	1	0	1	1	0	0	3
OG0008028	3	0	0	0	0	0	3
OG0008029	1	0	1	0	0	1	3
OG0008030	2	0	1	0	0	0	3
OG0008031	2	0	0	1	0	0	3
OG0008032	1	0	1	1	0	0	3
OG0008033	1	0	1	0	1	0	3
OG0008034	1	1	1	0	0	0	3
OG0008035	1	0	1	0	1	0	3
OG0008036	1	1	1	0	0	0	3
OG0008037	3	0	0	0	0	0	3
OG0008038	2	0	1	0	0	0	3
OG0008039	3	0	0	0	0	0	3
OG0008040	1	0	1	0	1	0	3
OG0008041	1	0	1	1	0	0	3
OG0008042	3	0	0	0	0	0	3
OG0008043	1	0	0	1	0	1	3
OG0008044	1	0	1	1	0	0	3
OG0008045	1	0	1	0	1	0	3
OG0008046	1	0	1	0	1	0	3
OG0008047	1	0	1	0	0	1	3
OG0008048	1	0	1	1	0	0	3
OG0008049	1	0	1	0	0	1	3
OG0008050	1	0	1	0	0	1	3
OG0008051	1	0	1	0	1	0	3
OG0008052	1	0	1	0	1	0	3
OG0008053	1	1	0	0	0	1	3
OG0008054	1	0	0	2	0	0	3
OG0008055	1	0	1	1	0	0	3
OG0008056	1	0	1	0	0	1	3
OG0008057	3	0	0	0	0	0	3
OG0008058	3	0	0	0	0	0	3
OG0008059	1	0	0	0	1	1	3
OG0008060	1	0	1	1	0	0	3
OG0008061	1	0	1	1	0	0	3
OG0008062	1	0	1	0	1	0	3
OG0008063	1	0	1	1	0	0	3
OG0008064	1	0	0	1	0	1	3
OG0008065	1	0	0	0	2	0	3
OG0008066	2	0	1	0	0	0	3
OG0008067	1	0	1	0	0	1	3
OG0008068	2	1	0	0	0	0	3
OG0008069	1	0	1	0	0	1	3
OG0008070	1	1	1	0	0	0	3
OG0008071	1	0	1	0	0	1	3
OG0008072	1	1	1	0	0	0	3
OG0008073	2	0	0	1	0	0	3
OG0008074	1	0	1	0	1	0	3
OG0008075	3	0	0	0	0	0	3
OG0008076	1	0	1	0	1	0	3
OG0008077	3	0	0	0	0	0	3
OG0008078	1	0	1	0	0	1	3
OG0008079	3	0	0	0	0	0	3
OG0008080	1	0	1	0	1	0	3
OG0008081	1	0	1	0	0	1	3
OG0008082	1	0	1	0	0	1	3
OG0008083	1	0	1	0	1	0	3
OG0008084	1	0	1	0	1	0	3
OG0008085	1	2	0	0	0	0	3
OG0008086	1	1	0	1	0	0	3
OG0008087	1	1	0	1	0	0	3
OG0008088	1	1	1	0	0	0	3
OG0008089	1	0	1	0	0	1	3
OG0008090	3	0	0	0	0	0	3
OG0008091	2	1	0	0	0	0	3
OG0008092	1	1	1	0	0	0	3
OG0008093	1	1	1	0	0	0	3
OG0008094	1	0	1	1	0	0	3
OG0008095	3	0	0	0	0	0	3
OG0008096	1	0	1	1	0	0	3
OG0008097	1	1	0	0	1	0	3
OG0008098	1	0	1	1	0	0	3
OG0008099	1	0	1	0	1	0	3
OG0008100	1	0	1	0	1	0	3
OG0008101	1	0	0	1	1	0	3
OG0008102	1	0	1	1	0	0	3
OG0008103	3	0	0	0	0	0	3
OG0008104	3	0	0	0	0	0	3
OG0008105	2	0	1	0	0	0	3
OG0008106	1	0	1	0	1	0	3
OG0008107	1	0	1	1	0	0	3
OG0008108	1	1	0	1	0	0	3
OG0008109	1	0	1	1	0	0	3
OG0008110	1	1	1	0	0	0	3
OG0008111	1	1	0	1	0	0	3
OG0008112	1	0	1	1	0	0	3
OG0008113	1	1	0	1	0	0	3
OG0008114	1	0	1	1	0	0	3
OG0008115	3	0	0	0	0	0	3
OG0008116	1	0	1	0	0	1	3
OG0008117	2	0	1	0	0	0	3
OG0008118	3	0	0	0	0	0	3
OG0008119	1	0	1	0	1	0	3
OG0008120	1	1	0	1	0	0	3
OG0008121	1	0	1	1	0	0	3
OG0008122	1	0	1	0	1	0	3
OG0008123	1	0	1	0	0	1	3
OG0008124	1	0	1	0	0	1	3
OG0008125	1	0	0	2	0	0	3
OG0008126	1	1	0	1	0	0	3
OG0008127	1	0	1	0	1	0	3
OG0008128	1	1	0	0	0	1	3
OG0008129	1	0	1	1	0	0	3
OG0008130	1	0	1	1	0	0	3
OG0008131	1	0	1	0	1	0	3
OG0008132	1	0	1	1	0	0	3
OG0008133	1	1	0	1	0	0	3
OG0008134	2	0	1	0	0	0	3
OG0008135	1	0	1	0	1	0	3
OG0008136	1	0	1	0	0	1	3
OG0008137	1	1	1	0	0	0	3
OG0008138	1	0	1	0	0	1	3
OG0008139	1	0	1	0	1	0	3
OG0008140	1	0	1	0	1	0	3
OG0008141	1	0	1	0	1	0	3
OG0008142	1	0	1	0	1	0	3
OG0008143	1	0	1	0	0	1	3
OG0008144	2	0	0	1	0	0	3
OG0008145	1	0	1	0	1	0	3
OG0008146	1	0	0	1	1	0	3
OG0008147	1	0	0	1	0	1	3
OG0008148	1	1	0	1	0	0	3
OG0008149	3	0	0	0	0	0	3
OG0008150	2	0	1	0	0	0	3
OG0008151	1	0	1	1	0	0	3
OG0008152	1	0	1	1	0	0	3
OG0008153	1	0	1	1	0	0	3
OG0008154	3	0	0	0	0	0	3
OG0008155	1	0	1	1	0	0	3
OG0008156	1	0	1	0	0	1	3
OG0008157	1	1	0	0	0	1	3
OG0008158	2	0	1	0	0	0	3
OG0008159	3	0	0	0	0	0	3
OG0008160	3	0	0	0	0	0	3
OG0008161	1	0	1	1	0	0	3
OG0008162	1	0	0	1	0	1	3
OG0008163	1	0	1	0	1	0	3
OG0008164	1	0	1	1	0	0	3
OG0008165	1	0	1	1	0	0	3
OG0008166	1	0	1	0	1	0	3
OG0008167	1	0	1	1	0	0	3
OG0008168	2	1	0	0	0	0	3
OG0008169	1	0	1	0	1	0	3
OG0008170	3	0	0	0	0	0	3
OG0008171	1	0	0	0	1	1	3
OG0008172	1	0	1	0	1	0	3
OG0008173	3	0	0	0	0	0	3
OG0008174	1	1	0	1	0	0	3
OG0008175	3	0	0	0	0	0	3
OG0008176	1	0	1	1	0	0	3
OG0008177	1	0	1	1	0	0	3
OG0008178	1	0	1	1	0	0	3
OG0008179	1	0	1	0	1	0	3
OG0008180	1	0	1	1	0	0	3
OG0008181	3	0	0	0	0	0	3
OG0008182	3	0	0	0	0	0	3
OG0008183	2	0	1	0	0	0	3
OG0008184	1	0	1	0	0	1	3
OG0008185	1	0	1	0	0	1	3
OG0008186	1	0	1	0	0	1	3
OG0008187	3	0	0	0	0	0	3
OG0008188	1	0	1	0	1	0	3
OG0008189	1	0	1	1	0	0	3
OG0008190	1	0	1	1	0	0	3
OG0008191	1	0	1	1	0	0	3
OG0008192	1	0	0	1	0	1	3
OG0008193	1	0	1	0	1	0	3
OG0008194	1	1	1	0	0	0	3
OG0008195	1	0	1	1	0	0	3
OG0008196	1	1	1	0	0	0	3
OG0008197	1	1	1	0	0	0	3
OG0008198	3	0	0	0	0	0	3
OG0008199	3	0	0	0	0	0	3
OG0008200	1	0	1	0	0	1	3
OG0008201	3	0	0	0	0	0	3
OG0008202	3	0	0	0	0	0	3
OG0008203	1	0	1	0	1	0	3
OG0008204	1	0	1	0	0	1	3
OG0008205	1	0	0	0	1	1	3
OG0008206	1	0	1	1	0	0	3
OG0008207	2	0	1	0	0	0	3
OG0008208	1	0	1	0	0	1	3
OG0008209	1	0	1	1	0	0	3
OG0008210	1	0	1	0	0	1	3
OG0008211	1	0	0	1	1	0	3
OG0008212	2	0	1	0	0	0	3
OG0008213	3	0	0	0	0	0	3
OG0008214	1	0	1	0	0	1	3
OG0008215	1	0	1	0	0	1	3
OG0008216	1	0	1	0	1	0	3
OG0008217	3	0	0	0	0	0	3
OG0008218	1	1	1	0	0	0	3
OG0008219	2	0	1	0	0	0	3
OG0008220	1	0	0	2	0	0	3
OG0008221	1	1	1	0	0	0	3
OG0008222	1	0	1	0	0	1	3
OG0008223	1	1	0	0	0	1	3
OG0008224	1	0	1	1	0	0	3
OG0008225	2	0	1	0	0	0	3
OG0008226	2	0	1	0	0	0	3
OG0008227	1	0	1	1	0	0	3
OG0008228	3	0	0	0	0	0	3
OG0008229	1	1	1	0	0	0	3
OG0008230	1	0	1	1	0	0	3
OG0008231	1	1	1	0	0	0	3
OG0008232	1	0	1	0	1	0	3
OG0008233	1	2	0	0	0	0	3
OG0008234	1	0	1	0	0	1	3
OG0008235	1	0	0	1	1	0	3
OG0008236	1	0	0	1	0	1	3
OG0008237	1	0	1	0	0	1	3
OG0008238	1	1	0	1	0	0	3
OG0008239	1	0	0	0	1	1	3
OG0008240	1	0	1	0	0	1	3
OG0008241	2	0	1	0	0	0	3
OG0008242	1	0	0	1	1	0	3
OG0008243	1	1	1	0	0	0	3
OG0008244	1	1	1	0	0	0	3
OG0008245	1	0	1	0	0	1	3
OG0008246	1	1	0	1	0	0	3
OG0008247	1	0	1	1	0	0	3
OG0008248	1	0	1	0	0	1	3
OG0008249	1	1	0	1	0	0	3
OG0008250	1	0	1	1	0	0	3
OG0008251	3	0	0	0	0	0	3
OG0008252	1	0	1	0	0	1	3
OG0008253	1	0	1	0	1	0	3
OG0008254	1	0	1	0	1	0	3
OG0008255	1	0	1	0	1	0	3
OG0008256	1	1	0	1	0	0	3
OG0008257	1	0	1	0	0	1	3
OG0008258	3	0	0	0	0	0	3
OG0008259	1	0	1	1	0	0	3
OG0008260	1	0	1	0	0	1	3
OG0008261	2	0	1	0	0	0	3
OG0008262	3	0	0	0	0	0	3
OG0008263	3	0	0	0	0	0	3
OG0008264	1	0	1	0	0	1	3
OG0008265	1	0	1	0	1	0	3
OG0008266	1	0	1	0	1	0	3
OG0008267	1	1	1	0	0	0	3
OG0008268	1	0	1	0	0	1	3
OG0008269	1	0	1	1	0	0	3
OG0008270	1	0	1	1	0	0	3
OG0008271	1	0	1	0	0	1	3
OG0008272	1	0	1	0	1	0	3
OG0008273	3	0	0	0	0	0	3
OG0008274	1	0	1	0	1	0	3
OG0008275	1	0	1	1	0	0	3
OG0008276	1	0	1	1	0	0	3
OG0008277	1	1	1	0	0	0	3
OG0008278	1	0	1	0	1	0	3
OG0008279	3	0	0	0	0	0	3
OG0008280	1	0	0	0	2	0	3
OG0008281	1	1	0	1	0	0	3
OG0008282	1	0	1	0	0	1	3
OG0008283	1	0	1	0	1	0	3
OG0008284	1	1	0	0	1	0	3
OG0008285	1	0	0	1	1	0	3
OG0008286	1	0	1	1	0	0	3
OG0008287	1	0	1	1	0	0	3
OG0008288	1	0	0	0	1	1	3
OG0008289	1	1	1	0	0	0	3
OG0008290	1	0	1	0	1	0	3
OG0008291	1	1	0	0	1	0	3
OG0008292	1	1	1	0	0	0	3
OG0008293	1	0	1	0	1	0	3
OG0008294	1	0	1	0	0	1	3
OG0008295	1	0	1	0	0	1	3
OG0008296	1	0	1	0	0	1	3
OG0008297	1	0	1	0	1	0	3
OG0008298	1	0	1	0	0	1	3
OG0008299	1	0	0	2	0	0	3
OG0008300	1	0	1	1	0	0	3
OG0008301	3	0	0	0	0	0	3
OG0008302	1	0	1	1	0	0	3
OG0008303	1	0	1	0	1	0	3
OG0008304	1	1	1	0	0	0	3
OG0008305	1	2	0	0	0	0	3
OG0008306	1	0	1	0	0	1	3
OG0008307	3	0	0	0	0	0	3
OG0008308	1	0	1	0	1	0	3
OG0008309	1	0	1	0	1	0	3
OG0008310	2	0	0	1	0	0	3
OG0008311	1	0	1	0	1	0	3
OG0008312	1	1	1	0	0	0	3
OG0008313	1	0	1	0	1	0	3
OG0008314	1	0	1	0	0	1	3
OG0008315	1	1	0	0	1	0	3
OG0008316	1	0	1	0	1	0	3
OG0008317	3	0	0	0	0	0	3
OG0008318	1	1	1	0	0	0	3
OG0008319	2	0	0	1	0	0	3
OG0008320	1	0	1	1	0	0	3
OG0008321	1	1	0	1	0	0	3
OG0008322	1	0	1	0	1	0	3
OG0008323	1	0	1	1	0	0	3
OG0008324	1	0	1	1	0	0	3
OG0008325	1	0	0	1	0	1	3
OG0008326	1	0	1	0	0	1	3
OG0008327	1	0	1	1	0	0	3
OG0008328	1	0	1	1	0	0	3
OG0008329	1	1	1	0	0	0	3
OG0008330	1	0	1	0	0	1	3
OG0008331	1	0	1	0	0	1	3
OG0008332	1	0	1	1	0	0	3
OG0008333	1	0	1	0	0	1	3
OG0008334	1	1	0	0	1	0	3
OG0008335	1	0	1	0	0	1	3
OG0008336	1	1	1	0	0	0	3
OG0008337	1	1	1	0	0	0	3
OG0008338	1	0	0	1	0	1	3
OG0008339	1	0	1	0	0	1	3
OG0008340	1	0	1	0	1	0	3
OG0008341	1	0	1	1	0	0	3
OG0008342	2	0	1	0	0	0	3
OG0008343	1	0	1	1	0	0	3
OG0008344	1	0	1	0	1	0	3
OG0008345	3	0	0	0	0	0	3
OG0008346	3	0	0	0	0	0	3
OG0008347	3	0	0	0	0	0	3
OG0008348	1	1	1	0	0	0	3
OG0008349	1	0	1	0	1	0	3
OG0008350	1	0	1	0	1	0	3
OG0008351	1	0	1	1	0	0	3
OG0008352	1	1	0	0	0	1	3
OG0008353	1	0	1	1	0	0	3
OG0008354	1	0	0	0	2	0	3
OG0008355	1	1	1	0	0	0	3
OG0008356	1	0	1	0	0	1	3
OG0008357	1	1	1	0	0	0	3
OG0008358	1	0	1	1	0	0	3
OG0008359	1	0	1	1	0	0	3
OG0008360	1	0	1	0	1	0	3
OG0008361	1	1	0	1	0	0	3
OG0008362	3	0	0	0	0	0	3
OG0008363	1	0	0	1	0	1	3
OG0008364	1	1	0	0	1	0	3
OG0008365	2	0	1	0	0	0	3
OG0008366	1	0	1	0	1	0	3
OG0008367	1	2	0	0	0	0	3
OG0008368	2	1	0	0	0	0	3
OG0008369	1	1	1	0	0	0	3
OG0008370	1	0	0	1	1	0	3
OG0008371	3	0	0	0	0	0	3
OG0008372	1	0	1	1	0	0	3
OG0008373	1	0	0	1	0	1	3
OG0008374	1	0	1	0	0	1	3
OG0008375	1	0	1	0	1	0	3
OG0008376	1	0	1	0	1	0	3
OG0008377	3	0	0	0	0	0	3
OG0008378	1	1	1	0	0	0	3
OG0008379	1	0	1	0	1	0	3
OG0008380	1	0	1	1	0	0	3
OG0008381	3	0	0	0	0	0	3
OG0008382	1	0	1	0	1	0	3
OG0008383	1	0	2	0	0	0	3
OG0008384	1	0	1	1	0	0	3
OG0008385	3	0	0	0	0	0	3
OG0008386	3	0	0	0	0	0	3
OG0008387	3	0	0	0	0	0	3
OG0008388	1	0	1	1	0	0	3
OG0008389	1	1	0	1	0	0	3
OG0008390	1	0	1	1	0	0	3
OG0008391	2	0	1	0	0	0	3
OG0008392	2	1	0	0	0	0	3
OG0008393	1	0	1	0	0	1	3
OG0008394	1	0	1	1	0	0	3
OG0008395	1	0	1	0	0	1	3
OG0008396	1	0	1	0	0	1	3
OG0008397	1	0	1	0	1	0	3
OG0008398	1	0	1	0	0	1	3
OG0008399	2	1	0	0	0	0	3
OG0008400	1	0	1	1	0	0	3
OG0008401	1	1	1	0	0	0	3
OG0008402	1	1	1	0	0	0	3
OG0008403	1	0	1	1	0	0	3
OG0008404	1	0	1	0	1	0	3
OG0008405	1	0	0	2	0	0	3
OG0008406	1	0	1	1	0	0	3
OG0008407	3	0	0	0	0	0	3
OG0008408	3	0	0	0	0	0	3
OG0008409	1	0	1	0	0	1	3
OG0008410	1	0	0	0	1	1	3
OG0008411	1	0	1	0	0	1	3
OG0008412	1	0	1	1	0	0	3
OG0008413	1	0	1	0	1	0	3
OG0008414	1	0	1	0	0	1	3
OG0008415	1	1	1	0	0	0	3
OG0008416	1	0	1	0	0	1	3
OG0008417	1	0	0	0	1	1	3
OG0008418	1	0	1	1	0	0	3
OG0008419	1	1	0	1	0	0	3
OG0008420	1	1	0	1	0	0	3
OG0008421	1	1	1	0	0	0	3
OG0008422	1	0	1	1	0	0	3
OG0008423	1	0	1	1	0	0	3
OG0008424	1	0	1	0	1	0	3
OG0008425	1	0	1	0	1	0	3
OG0008426	1	0	1	1	0	0	3
OG0008427	1	0	1	0	0	1	3
OG0008428	1	0	1	0	0	1	3
OG0008429	1	0	1	1	0	0	3
OG0008430	1	0	1	0	1	0	3
OG0008431	1	2	0	0	0	0	3
OG0008432	1	1	0	1	0	0	3
OG0008433	1	1	1	0	0	0	3
OG0008434	1	1	0	1	0	0	3
OG0008435	1	0	1	1	0	0	3
OG0008436	1	0	1	0	1	0	3
OG0008437	1	0	1	0	1	0	3
OG0008438	1	1	0	0	0	1	3
OG0008439	1	0	1	1	0	0	3
OG0008440	1	0	1	0	0	1	3
OG0008441	1	0	1	0	1	0	3
OG0008442	1	0	1	0	0	1	3
OG0008443	1	0	1	0	0	1	3
OG0008444	1	0	1	0	0	1	3
OG0008445	1	0	0	1	1	0	3
OG0008446	1	0	1	0	0	1	3
OG0008447	1	1	1	0	0	0	3
OG0008448	1	0	1	1	0	0	3
OG0008449	1	0	1	1	0	0	3
OG0008450	1	0	1	0	1	0	3
OG0008451	1	0	1	0	1	0	3
OG0008452	1	1	0	1	0	0	3
OG0008453	1	0	0	0	1	1	3
OG0008454	1	0	1	1	0	0	3
OG0008455	1	1	1	0	0	0	3
OG0008456	1	0	0	1	1	0	3
OG0008457	1	0	1	1	0	0	3
OG0008458	1	0	1	0	0	1	3
OG0008459	1	0	1	1	0	0	3
OG0008460	1	0	1	1	0	0	3
OG0008461	1	1	1	0	0	0	3
OG0008462	1	0	1	0	1	0	3
OG0008463	1	1	1	0	0	0	3
OG0008464	1	0	1	0	1	0	3
OG0008465	1	1	1	0	0	0	3
OG0008466	1	1	0	1	0	0	3
OG0008467	1	0	1	0	0	1	3
OG0008468	1	0	1	0	1	0	3
OG0008469	1	0	1	1	0	0	3
OG0008470	1	0	0	0	1	1	3
OG0008471	1	2	0	0	0	0	3
OG0008472	1	0	1	1	0	0	3
OG0008473	1	0	1	0	0	1	3
OG0008474	1	0	0	1	1	0	3
OG0008475	2	0	1	0	0	0	3
OG0008476	1	0	1	0	1	0	3
OG0008477	1	1	1	0	0	0	3
OG0008478	1	0	1	0	1	0	3
OG0008479	1	0	1	0	1	0	3
OG0008480	1	0	1	1	0	0	3
OG0008481	1	1	1	0	0	0	3
OG0008482	1	0	0	0	1	1	3
OG0008483	1	0	1	0	1	0	3
OG0008484	1	0	1	1	0	0	3
OG0008485	1	0	1	0	1	0	3
OG0008486	1	0	0	1	1	0	3
OG0008487	1	0	1	1	0	0	3
OG0008488	1	1	0	1	0	0	3
OG0008489	1	1	0	1	0	0	3
OG0008490	1	2	0	0	0	0	3
OG0008491	1	1	1	0	0	0	3
OG0008492	1	0	1	0	0	1	3
OG0008493	1	0	1	1	0	0	3
OG0008494	1	1	1	0	0	0	3
OG0008495	1	0	0	1	1	0	3
OG0008496	1	0	1	0	0	1	3
OG0008497	1	1	1	0	0	0	3
OG0008498	1	0	1	1	0	0	3
OG0008499	1	0	1	1	0	0	3
OG0008500	1	0	2	0	0	0	3
OG0008501	0	2	0	1	0	0	3
OG0008502	0	1	1	0	1	0	3
OG0008503	0	1	1	1	0	0	3
OG0008504	0	1	1	1	0	0	3
OG0008505	0	1	1	1	0	0	3
OG0008506	0	1	1	0	1	0	3
OG0008507	0	1	0	1	1	0	3
OG0008508	0	1	1	0	0	1	3
OG0008509	0	1	1	1	0	0	3
OG0008510	0	1	1	1	0	0	3
OG0008511	0	1	0	2	0	0	3
OG0008512	0	1	1	0	0	1	3
OG0008513	0	1	1	1	0	0	3
OG0008514	0	1	1	1	0	0	3
OG0008515	0	2	0	1	0	0	3
OG0008516	0	1	1	1	0	0	3
OG0008517	0	1	1	1	0	0	3
OG0008518	0	1	1	0	1	0	3
OG0008519	0	2	1	0	0	0	3
OG0008520	0	1	1	0	1	0	3
OG0008521	0	1	0	1	1	0	3
OG0008522	0	1	1	1	0	0	3
OG0008523	0	1	1	1	0	0	3
OG0008524	0	1	1	1	0	0	3
OG0008525	0	1	1	1	0	0	3
OG0008526	0	1	1	1	0	0	3
OG0008527	0	1	1	1	0	0	3
OG0008528	0	1	1	1	0	0	3
OG0008529	0	1	1	0	1	0	3
OG0008530	0	1	1	0	0	1	3
OG0008531	0	1	1	0	1	0	3
OG0008532	0	1	1	0	1	0	3
OG0008533	0	1	1	1	0	0	3
OG0008534	0	2	1	0	0	0	3
OG0008535	0	1	1	0	1	0	3
OG0008536	0	1	1	0	1	0	3
OG0008537	0	1	1	0	1	0	3
OG0008538	0	1	1	1	0	0	3
OG0008539	0	1	1	0	0	1	3
OG0008540	0	1	1	1	0	0	3
OG0008541	0	2	1	0	0	0	3
OG0008542	0	1	1	1	0	0	3
OG0008543	0	1	1	1	0	0	3
OG0008544	0	1	1	0	1	0	3
OG0008545	0	1	1	0	0	1	3
OG0008546	0	1	1	0	1	0	3
OG0008547	0	1	1	0	1	0	3
OG0008548	0	3	0	0	0	0	3
OG0008549	0	1	0	1	0	1	3
OG0008550	0	1	1	1	0	0	3
OG0008551	0	1	1	0	1	0	3
OG0008552	0	1	1	1	0	0	3
OG0008553	0	1	0	0	1	1	3
OG0008554	0	1	1	0	1	0	3
OG0008555	0	1	1	1	0	0	3
OG0008556	0	1	1	0	1	0	3
OG0008557	0	1	1	0	1	0	3
OG0008558	0	1	1	0	0	1	3
OG0008559	0	1	1	0	1	0	3
OG0008560	0	1	1	0	0	1	3
OG0008561	0	1	1	0	1	0	3
OG0008562	0	1	0	1	0	1	3
OG0008563	0	1	0	2	0	0	3
OG0008564	0	1	0	0	2	0	3
OG0008565	0	1	1	0	1	0	3
OG0008566	0	1	1	0	0	1	3
OG0008567	0	1	0	2	0	0	3
OG0008568	0	1	1	0	1	0	3
OG0008569	0	1	1	0	0	1	3
OG0008570	0	1	0	0	1	1	3
OG0008571	0	1	1	0	1	0	3
OG0008572	0	1	1	1	0	0	3
OG0008573	0	2	0	1	0	0	3
OG0008574	0	1	0	1	0	1	3
OG0008575	0	1	1	0	1	0	3
OG0008576	0	1	1	1	0	0	3
OG0008577	0	1	1	0	0	1	3
OG0008578	0	2	1	0	0	0	3
OG0008579	0	1	1	1	0	0	3
OG0008580	0	1	1	0	1	0	3
OG0008581	0	1	1	0	0	1	3
OG0008582	0	1	1	0	0	1	3
OG0008583	0	1	1	0	0	1	3
OG0008584	0	1	1	0	1	0	3
OG0008585	0	1	0	2	0	0	3
OG0008586	0	1	1	0	1	0	3
OG0008587	0	1	1	1	0	0	3
OG0008588	0	1	1	1	0	0	3
OG0008589	0	1	1	0	1	0	3
OG0008590	0	1	1	0	0	1	3
OG0008591	0	1	1	1	0	0	3
OG0008592	0	1	1	0	0	1	3
OG0008593	0	1	1	1	0	0	3
OG0008594	0	1	1	1	0	0	3
OG0008595	0	1	1	1	0	0	3
OG0008596	0	1	1	1	0	0	3
OG0008597	0	1	1	0	1	0	3
OG0008598	0	1	1	0	1	0	3
OG0008599	0	1	1	0	0	1	3
OG0008600	0	1	0	1	1	0	3
OG0008601	0	1	0	2	0	0	3
OG0008602	0	1	1	0	1	0	3
OG0008603	0	1	1	0	0	1	3
OG0008604	0	1	0	0	0	2	3
OG0008605	0	1	1	0	1	0	3
OG0008606	0	1	1	1	0	0	3
OG0008607	0	2	0	1	0	0	3
OG0008608	0	1	1	0	1	0	3
OG0008609	0	1	0	1	1	0	3
OG0008610	0	1	0	2	0	0	3
OG0008611	0	1	1	0	0	1	3
OG0008612	0	1	1	1	0	0	3
OG0008613	0	1	1	0	0	1	3
OG0008614	0	1	1	1	0	0	3
OG0008615	0	1	0	1	0	1	3
OG0008616	0	1	0	2	0	0	3
OG0008617	0	1	1	0	1	0	3
OG0008618	0	3	0	0	0	0	3
OG0008619	0	1	1	0	1	0	3
OG0008620	0	2	0	0	0	1	3
OG0008621	0	1	1	0	0	1	3
OG0008622	0	1	0	1	1	0	3
OG0008623	0	1	1	0	1	0	3
OG0008624	0	1	0	0	1	1	3
OG0008625	0	1	0	2	0	0	3
OG0008626	0	1	0	0	2	0	3
OG0008627	0	1	0	2	0	0	3
OG0008628	0	1	0	2	0	0	3
OG0008629	0	1	1	1	0	0	3
OG0008630	0	1	1	1	0	0	3
OG0008631	0	3	0	0	0	0	3
OG0008632	0	1	0	2	0	0	3
OG0008633	0	3	0	0	0	0	3
OG0008634	0	3	0	0	0	0	3
OG0008635	0	1	0	1	1	0	3
OG0008636	0	1	0	0	1	1	3
OG0008637	0	1	1	1	0	0	3
OG0008638	0	1	1	0	1	0	3
OG0008639	0	1	1	0	0	1	3
OG0008640	0	1	1	1	0	0	3
OG0008641	0	1	0	2	0	0	3
OG0008642	0	1	0	1	1	0	3
OG0008643	0	1	1	1	0	0	3
OG0008644	0	1	1	0	1	0	3
OG0008645	0	1	1	1	0	0	3
OG0008646	0	1	0	0	1	1	3
OG0008647	0	1	1	0	0	1	3
OG0008648	0	1	1	1	0	0	3
OG0008649	0	1	1	0	1	0	3
OG0008650	0	1	1	1	0	0	3
OG0008651	0	2	0	1	0	0	3
OG0008652	0	1	1	0	0	1	3
OG0008653	0	1	1	0	1	0	3
OG0008654	0	1	0	1	0	1	3
OG0008655	0	1	0	1	1	0	3
OG0008656	0	3	0	0	0	0	3
OG0008657	0	1	1	0	0	1	3
OG0008658	0	1	0	0	1	1	3
OG0008659	0	1	1	1	0	0	3
OG0008660	0	1	1	0	1	0	3
OG0008661	0	1	1	0	0	1	3
OG0008662	0	2	1	0	0	0	3
OG0008663	0	3	0	0	0	0	3
OG0008664	0	0	1	1	1	0	3
OG0008665	0	0	1	1	0	1	3
OG0008666	0	0	1	0	1	1	3
OG0008667	0	0	3	0	0	0	3
OG0008668	0	0	1	1	0	1	3
OG0008669	0	0	3	0	0	0	3
OG0008670	0	0	1	0	1	1	3
OG0008671	0	0	1	0	1	1	3
OG0008672	0	0	1	0	1	1	3
OG0008673	0	0	1	0	1	1	3
OG0008674	0	0	1	1	1	0	3
OG0008675	0	0	1	0	1	1	3
OG0008676	0	0	1	1	0	1	3
OG0008677	0	0	1	0	1	1	3
OG0008678	0	0	1	1	0	1	3
OG0008679	0	0	1	2	0	0	3
OG0008680	0	0	1	0	1	1	3
OG0008681	0	0	1	0	1	1	3
OG0008682	0	0	1	0	2	0	3
OG0008683	0	0	1	1	1	0	3
OG0008684	0	0	1	0	1	1	3
OG0008685	0	0	1	1	0	1	3
OG0008686	0	0	1	0	1	1	3
OG0008687	0	0	1	0	1	1	3
OG0008688	0	0	1	1	1	0	3
OG0008689	0	0	1	1	1	0	3
OG0008690	0	0	1	1	0	1	3
OG0008691	0	0	1	0	1	1	3
OG0008692	0	0	1	1	1	0	3
OG0008693	0	0	1	0	1	1	3
OG0008694	0	0	1	0	1	1	3
OG0008695	0	0	1	0	1	1	3
OG0008696	0	0	1	0	1	1	3
OG0008697	0	0	3	0	0	0	3
OG0008698	0	0	1	1	1	0	3
OG0008699	0	0	1	0	1	1	3
OG0008700	0	0	3	0	0	0	3
OG0008701	0	0	1	1	0	1	3
OG0008702	0	0	1	1	1	0	3
OG0008703	0	0	1	0	1	1	3
OG0008704	0	0	3	0	0	0	3
OG0008705	0	0	1	0	1	1	3
OG0008706	0	0	1	0	2	0	3
OG0008707	0	0	1	0	1	1	3
OG0008708	0	0	2	0	0	1	3
OG0008709	0	0	1	0	1	1	3
OG0008710	0	0	1	0	1	1	3
OG0008711	0	0	1	0	1	1	3
OG0008712	0	0	1	1	1	0	3
OG0008713	0	0	1	1	1	0	3
OG0008714	0	0	1	0	1	1	3
OG0008715	0	0	1	1	0	1	3
OG0008716	0	0	3	0	0	0	3
OG0008717	0	0	3	0	0	0	3
OG0008718	0	0	3	0	0	0	3
OG0008719	0	0	3	0	0	0	3
OG0008720	0	0	1	1	0	1	3
OG0008721	0	0	1	1	0	1	3
OG0008722	0	0	1	1	0	1	3
OG0008723	0	0	1	1	0	1	3
OG0008724	0	0	1	0	1	1	3
OG0008725	0	0	1	2	0	0	3
OG0008726	0	0	3	0	0	0	3
OG0008727	0	0	1	0	1	1	3
OG0008728	0	0	1	1	1	0	3
OG0008729	0	0	1	0	1	1	3
OG0008730	0	0	1	1	0	1	3
OG0008731	0	0	3	0	0	0	3
OG0008732	0	0	1	0	1	1	3
OG0008733	0	0	1	2	0	0	3
OG0008734	0	0	1	0	1	1	3
OG0008735	0	0	1	0	1	1	3
OG0008736	0	0	1	1	1	0	3
OG0008737	0	0	1	0	1	1	3
OG0008738	0	0	1	0	1	1	3
OG0008739	0	0	1	0	1	1	3
OG0008740	0	0	1	0	1	1	3
OG0008741	0	0	1	1	1	0	3
OG0008742	0	0	1	1	0	1	3
OG0008743	0	0	1	2	0	0	3
OG0008744	0	0	1	0	1	1	3
OG0008745	0	0	1	1	1	0	3
OG0008746	0	0	1	1	1	0	3
OG0008747	0	0	2	0	1	0	3
OG0008748	0	0	1	1	1	0	3
OG0008749	0	0	1	0	1	1	3
OG0008750	0	0	2	1	0	0	3
OG0008751	0	0	1	0	1	1	3
OG0008752	0	0	1	0	1	1	3
OG0008753	0	0	1	0	1	1	3
OG0008754	0	0	1	0	1	1	3
OG0008755	0	0	1	0	2	0	3
OG0008756	0	0	1	0	1	1	3
OG0008757	0	0	1	1	0	1	3
OG0008758	0	0	1	1	1	0	3
OG0008759	0	0	1	1	1	0	3
OG0008760	0	0	1	1	1	0	3
OG0008761	0	0	1	0	1	1	3
OG0008762	0	0	1	0	2	0	3
OG0008763	0	0	1	1	1	0	3
OG0008764	0	0	1	0	1	1	3
OG0008765	0	0	1	1	0	1	3
OG0008766	0	0	1	1	0	1	3
OG0008767	0	0	1	1	1	0	3
OG0008768	0	0	1	1	1	0	3
OG0008769	0	0	1	0	1	1	3
OG0008770	0	0	1	0	1	1	3
OG0008771	0	0	3	0	0	0	3
OG0008772	0	0	3	0	0	0	3
OG0008773	0	0	1	0	1	1	3
OG0008774	0	0	1	1	1	0	3
OG0008775	0	0	1	1	0	1	3
OG0008776	0	0	1	1	0	1	3
OG0008777	0	0	1	0	1	1	3
OG0008778	0	0	1	1	0	1	3
OG0008779	0	0	1	0	1	1	3
OG0008780	0	0	1	0	1	1	3
OG0008781	0	0	3	0	0	0	3
OG0008782	0	0	1	0	1	1	3
OG0008783	0	0	1	1	0	1	3
OG0008784	0	0	1	0	2	0	3
OG0008785	0	0	1	0	1	1	3
OG0008786	0	0	1	1	0	1	3
OG0008787	0	0	1	0	1	1	3
OG0008788	0	0	1	1	0	1	3
OG0008789	0	0	1	1	0	1	3
OG0008790	0	0	1	1	0	1	3
OG0008791	0	0	1	1	0	1	3
OG0008792	0	0	3	0	0	0	3
OG0008793	0	0	1	0	1	1	3
OG0008794	0	0	1	0	1	1	3
OG0008795	0	0	1	1	1	0	3
OG0008796	0	0	1	1	0	1	3
OG0008797	0	0	1	1	0	1	3
OG0008798	0	0	1	1	1	0	3
OG0008799	0	0	1	1	1	0	3
OG0008800	0	0	1	2	0	0	3
OG0008801	0	0	1	0	1	1	3
OG0008802	0	0	1	0	2	0	3
OG0008803	0	0	1	0	1	1	3
OG0008804	0	0	1	0	1	1	3
OG0008805	0	0	1	1	1	0	3
OG0008806	0	0	1	1	1	0	3
OG0008807	0	0	1	0	0	2	3
OG0008808	0	0	1	1	0	1	3
OG0008809	0	0	1	1	0	1	3
OG0008810	0	0	1	0	1	1	3
OG0008811	0	0	1	0	1	1	3
OG0008812	0	0	1	1	0	1	3
OG0008813	0	0	1	1	0	1	3
OG0008814	0	0	1	0	1	1	3
OG0008815	0	0	1	1	1	0	3
OG0008816	0	0	1	0	1	1	3
OG0008817	0	0	2	0	0	1	3
OG0008818	0	0	1	1	0	1	3
OG0008819	0	0	1	0	1	1	3
OG0008820	0	0	1	1	0	1	3
OG0008821	0	0	1	1	0	1	3
OG0008822	0	0	1	1	0	1	3
OG0008823	0	0	1	0	1	1	3
OG0008824	0	0	1	1	1	0	3
OG0008825	0	0	1	0	1	1	3
OG0008826	0	0	1	1	1	0	3
OG0008827	0	0	1	0	1	1	3
OG0008828	0	0	1	1	1	0	3
OG0008829	0	0	1	1	0	1	3
OG0008830	0	0	1	1	1	0	3
OG0008831	0	0	1	1	0	1	3
OG0008832	0	0	1	0	1	1	3
OG0008833	0	0	1	1	0	1	3
OG0008834	0	0	1	0	1	1	3
OG0008835	0	0	1	1	1	0	3
OG0008836	0	0	1	0	0	2	3
OG0008837	0	0	1	0	1	1	3
OG0008838	0	0	1	1	0	1	3
OG0008839	0	0	1	1	1	0	3
OG0008840	0	0	1	1	0	1	3
OG0008841	0	0	1	2	0	0	3
OG0008842	0	0	1	0	1	1	3
OG0008843	0	0	1	1	0	1	3
OG0008844	0	0	1	0	1	1	3
OG0008845	0	0	1	1	1	0	3
OG0008846	0	0	1	0	1	1	3
OG0008847	0	0	1	1	1	0	3
OG0008848	0	0	1	1	1	0	3
OG0008849	0	0	1	0	1	1	3
OG0008850	0	0	1	0	1	1	3
OG0008851	0	0	1	1	0	1	3
OG0008852	0	0	1	0	2	0	3
OG0008853	0	0	1	0	1	1	3
OG0008854	0	0	1	1	0	1	3
OG0008855	0	0	1	0	1	1	3
OG0008856	0	0	1	1	0	1	3
OG0008857	0	0	1	1	0	1	3
OG0008858	0	0	1	0	1	1	3
OG0008859	0	0	1	0	1	1	3
OG0008860	0	0	1	1	1	0	3
OG0008861	0	0	1	0	2	0	3
OG0008862	0	0	1	1	0	1	3
OG0008863	0	0	1	1	0	1	3
OG0008864	0	0	1	0	1	1	3
OG0008865	0	0	1	1	0	1	3
OG0008866	0	0	1	0	1	1	3
OG0008867	0	0	1	0	1	1	3
OG0008868	0	0	1	0	1	1	3
OG0008869	0	0	1	0	1	1	3
OG0008870	0	0	1	1	0	1	3
OG0008871	0	0	1	2	0	0	3
OG0008872	0	0	1	1	1	0	3
OG0008873	0	0	1	1	1	0	3
OG0008874	0	0	1	1	1	0	3
OG0008875	0	0	1	0	2	0	3
OG0008876	0	0	1	1	0	1	3
OG0008877	0	0	1	0	1	1	3
OG0008878	0	0	1	1	0	1	3
OG0008879	0	0	1	1	1	0	3
OG0008880	0	0	1	0	1	1	3
OG0008881	0	0	1	0	1	1	3
OG0008882	0	0	1	2	0	0	3
OG0008883	0	0	1	1	1	0	3
OG0008884	0	0	3	0	0	0	3
OG0008885	0	0	1	0	1	1	3
OG0008886	0	0	1	0	1	1	3
OG0008887	0	0	1	1	1	0	3
OG0008888	0	0	1	0	1	1	3
OG0008889	0	0	1	0	1	1	3
OG0008890	0	0	1	1	1	0	3
OG0008891	0	0	1	0	1	1	3
OG0008892	0	0	1	1	1	0	3
OG0008893	0	0	1	0	1	1	3
OG0008894	0	0	1	0	1	1	3
OG0008895	0	0	1	1	1	0	3
OG0008896	0	0	1	1	0	1	3
OG0008897	0	0	1	0	1	1	3
OG0008898	0	0	1	0	1	1	3
OG0008899	0	0	1	1	0	1	3
OG0008900	0	0	1	1	1	0	3
OG0008901	0	0	1	1	1	0	3
OG0008902	0	0	1	1	0	1	3
OG0008903	0	0	1	0	1	1	3
OG0008904	0	0	1	1	1	0	3
OG0008905	0	0	1	1	0	1	3
OG0008906	0	0	1	1	0	1	3
OG0008907	0	0	1	0	1	1	3
OG0008908	0	0	1	0	1	1	3
OG0008909	0	0	1	0	1	1	3
OG0008910	0	0	1	1	0	1	3
OG0008911	0	0	1	1	0	1	3
OG0008912	0	0	1	0	1	1	3
OG0008913	0	0	1	0	1	1	3
OG0008914	0	0	1	0	1	1	3
OG0008915	0	0	1	0	1	1	3
OG0008916	0	0	1	0	1	1	3
OG0008917	0	0	1	0	1	1	3
OG0008918	0	0	1	0	0	2	3
OG0008919	0	0	1	1	1	0	3
OG0008920	0	0	1	0	1	1	3
OG0008921	0	0	1	0	1	1	3
OG0008922	0	0	1	1	0	1	3
OG0008923	0	0	3	0	0	0	3
OG0008924	0	0	1	0	1	1	3
OG0008925	0	0	1	1	0	1	3
OG0008926	0	0	1	0	2	0	3
OG0008927	0	0	1	0	1	1	3
OG0008928	0	0	1	1	0	1	3
OG0008929	0	0	1	1	1	0	3
OG0008930	0	0	1	1	1	0	3
OG0008931	0	0	1	0	1	1	3
OG0008932	0	0	1	1	1	0	3
OG0008933	0	0	1	0	2	0	3
OG0008934	0	0	1	1	0	1	3
OG0008935	0	0	1	1	0	1	3
OG0008936	0	0	1	1	1	0	3
OG0008937	0	0	1	1	1	0	3
OG0008938	0	0	1	1	0	1	3
OG0008939	0	0	1	1	0	1	3
OG0008940	0	0	1	1	1	0	3
OG0008941	0	0	1	1	0	1	3
OG0008942	0	0	1	0	1	1	3
OG0008943	0	0	1	0	1	1	3
OG0008944	0	0	1	0	1	1	3
OG0008945	0	0	1	0	1	1	3
OG0008946	0	0	3	0	0	0	3
OG0008947	0	0	1	0	1	1	3
OG0008948	0	0	1	1	1	0	3
OG0008949	0	0	1	1	1	0	3
OG0008950	0	0	1	0	1	1	3
OG0008951	0	0	1	0	1	1	3
OG0008952	0	0	1	0	1	1	3
OG0008953	0	0	1	0	1	1	3
OG0008954	0	0	1	0	1	1	3
OG0008955	0	0	1	0	1	1	3
OG0008956	0	0	1	1	1	0	3
OG0008957	0	0	1	0	1	1	3
OG0008958	0	0	1	1	0	1	3
OG0008959	0	0	1	2	0	0	3
OG0008960	0	0	1	0	1	1	3
OG0008961	0	0	1	1	0	1	3
OG0008962	0	0	1	2	0	0	3
OG0008963	0	0	1	0	1	1	3
OG0008964	0	0	1	1	1	0	3
OG0008965	0	0	1	0	1	1	3
OG0008966	0	0	1	1	1	0	3
OG0008967	0	0	1	0	1	1	3
OG0008968	0	0	1	0	1	1	3
OG0008969	0	0	1	0	1	1	3
OG0008970	0	0	1	2	0	0	3
OG0008971	0	0	1	1	1	0	3
OG0008972	0	0	1	0	2	0	3
OG0008973	0	0	1	0	1	1	3
OG0008974	0	0	1	0	1	1	3
OG0008975	0	0	1	0	1	1	3
OG0008976	0	0	1	0	1	1	3
OG0008977	0	0	1	0	1	1	3
OG0008978	0	0	1	1	1	0	3
OG0008979	0	0	1	1	1	0	3
OG0008980	0	0	1	0	1	1	3
OG0008981	0	0	1	1	1	0	3
OG0008982	0	0	1	0	1	1	3
OG0008983	0	0	1	0	1	1	3
OG0008984	0	0	2	0	1	0	3
OG0008985	0	0	1	0	1	1	3
OG0008986	0	0	1	0	1	1	3
OG0008987	0	0	1	0	1	1	3
OG0008988	0	0	1	0	1	1	3
OG0008989	0	0	1	1	1	0	3
OG0008990	0	0	1	0	1	1	3
OG0008991	0	0	1	0	1	1	3
OG0008992	0	0	1	0	1	1	3
OG0008993	0	0	1	1	0	1	3
OG0008994	0	0	1	0	1	1	3
OG0008995	0	0	1	0	1	1	3
OG0008996	0	0	1	1	0	1	3
OG0008997	0	0	1	0	1	1	3
OG0008998	0	0	2	0	0	1	3
OG0008999	0	0	1	1	0	1	3
OG0009000	0	0	1	0	2	0	3
OG0009001	0	0	1	1	0	1	3
OG0009002	0	0	1	0	1	1	3
OG0009003	0	0	1	1	0	1	3
OG0009004	0	0	1	0	1	1	3
OG0009005	0	0	1	0	1	1	3
OG0009006	0	0	1	0	1	1	3
OG0009007	0	0	1	1	1	0	3
OG0009008	0	0	1	0	1	1	3
OG0009009	0	0	1	0	1	1	3
OG0009010	0	0	1	1	0	1	3
OG0009011	0	0	1	1	0	1	3
OG0009012	0	0	1	0	0	2	3
OG0009013	0	0	1	0	2	0	3
OG0009014	0	0	1	1	1	0	3
OG0009015	0	0	1	1	0	1	3
OG0009016	0	0	1	1	1	0	3
OG0009017	0	0	1	1	1	0	3
OG0009018	0	0	1	0	1	1	3
OG0009019	0	0	1	1	0	1	3
OG0009020	0	0	1	1	0	1	3
OG0009021	0	0	1	1	0	1	3
OG0009022	0	0	1	1	1	0	3
OG0009023	0	0	1	0	1	1	3
OG0009024	0	0	1	0	0	2	3
OG0009025	0	0	0	1	1	1	3
OG0009026	0	0	0	3	0	0	3
OG0009027	0	0	0	1	1	1	3
OG0009028	0	0	0	1	1	1	3
OG0009029	0	0	0	1	1	1	3
OG0009030	0	0	0	1	1	1	3
OG0009031	0	0	0	3	0	0	3
OG0009032	0	0	0	1	1	1	3
OG0009033	0	0	0	1	2	0	3
OG0009034	0	0	0	1	1	1	3
OG0009035	0	0	0	3	0	0	3
OG0009036	0	0	0	1	1	1	3
OG0009037	0	0	0	3	0	0	3
OG0009038	0	0	0	3	0	0	3
OG0009039	0	0	0	1	1	1	3
OG0009040	0	0	0	3	0	0	3
OG0009041	0	0	0	1	1	1	3
OG0009042	0	0	0	1	1	1	3
OG0009043	0	0	0	1	1	1	3
OG0009044	0	0	0	3	0	0	3
OG0009045	0	0	0	2	1	0	3
OG0009046	0	0	0	3	0	0	3
OG0009047	0	0	0	1	1	1	3
OG0009048	0	0	0	1	1	1	3
OG0009049	0	0	0	1	1	1	3
OG0009050	0	0	0	1	1	1	3
OG0009051	0	0	0	3	0	0	3
OG0009052	0	0	0	3	0	0	3
OG0009053	0	0	0	2	0	1	3
OG0009054	0	0	0	1	1	1	3
OG0009055	0	0	0	1	1	1	3
OG0009056	0	0	0	0	3	0	3
OG0009057	0	0	0	0	2	1	3
OG0009058	0	0	0	0	1	2	3
OG0009059	0	0	0	0	2	1	3
OG0009060	0	0	0	0	2	1	3
OG0009061	0	0	0	0	2	1	3
OG0009062	0	0	0	0	2	1	3
OG0009063	0	0	0	0	3	0	3
OG0009064	0	0	0	0	3	0	3
OG0009065	0	0	0	0	2	1	3
OG0009066	0	0	0	0	3	0	3
OG0009067	0	0	0	0	3	0	3
OG0009068	0	0	0	0	1	2	3
OG0009069	0	0	0	0	1	2	3
OG0009070	0	0	0	0	0	3	3
OG0009071	0	0	0	0	0	3	3
OG0009072	0	0	0	0	0	3	3
OG0009073	0	0	0	0	0	3	3
OG0009074	0	0	0	0	0	3	3
OG0009075	1	0	1	0	0	0	2
OG0009076	2	0	0	0	0	0	2
OG0009077	1	0	0	1	0	0	2
OG0009078	2	0	0	0	0	0	2
OG0009079	2	0	0	0	0	0	2
OG0009080	1	0	1	0	0	0	2
OG0009081	2	0	0	0	0	0	2
OG0009082	2	0	0	0	0	0	2
OG0009083	2	0	0	0	0	0	2
OG0009084	2	0	0	0	0	0	2
OG0009085	2	0	0	0	0	0	2
OG0009086	2	0	0	0	0	0	2
OG0009087	2	0	0	0	0	0	2
OG0009088	2	0	0	0	0	0	2
OG0009089	2	0	0	0	0	0	2
OG0009090	2	0	0	0	0	0	2
OG0009091	2	0	0	0	0	0	2
OG0009092	2	0	0	0	0	0	2
OG0009093	2	0	0	0	0	0	2
OG0009094	1	0	1	0	0	0	2
OG0009095	2	0	0	0	0	0	2
OG0009096	2	0	0	0	0	0	2
OG0009097	1	0	1	0	0	0	2
OG0009098	2	0	0	0	0	0	2
OG0009099	2	0	0	0	0	0	2
OG0009100	2	0	0	0	0	0	2
OG0009101	2	0	0	0	0	0	2
OG0009102	2	0	0	0	0	0	2
OG0009103	2	0	0	0	0	0	2
OG0009104	2	0	0	0	0	0	2
OG0009105	2	0	0	0	0	0	2
OG0009106	2	0	0	0	0	0	2
OG0009107	1	0	1	0	0	0	2
OG0009108	2	0	0	0	0	0	2
OG0009109	2	0	0	0	0	0	2
OG0009110	2	0	0	0	0	0	2
OG0009111	2	0	0	0	0	0	2
OG0009112	2	0	0	0	0	0	2
OG0009113	1	0	1	0	0	0	2
OG0009114	2	0	0	0	0	0	2
OG0009115	2	0	0	0	0	0	2
OG0009116	2	0	0	0	0	0	2
OG0009117	2	0	0	0	0	0	2
OG0009118	2	0	0	0	0	0	2
OG0009119	2	0	0	0	0	0	2
OG0009120	1	0	1	0	0	0	2
OG0009121	2	0	0	0	0	0	2
OG0009122	2	0	0	0	0	0	2
OG0009123	2	0	0	0	0	0	2
OG0009124	2	0	0	0	0	0	2
OG0009125	2	0	0	0	0	0	2
OG0009126	1	0	0	1	0	0	2
OG0009127	2	0	0	0	0	0	2
OG0009128	2	0	0	0	0	0	2
OG0009129	2	0	0	0	0	0	2
OG0009130	2	0	0	0	0	0	2
OG0009131	1	1	0	0	0	0	2
OG0009132	2	0	0	0	0	0	2
OG0009133	2	0	0	0	0	0	2
OG0009134	2	0	0	0	0	0	2
OG0009135	2	0	0	0	0	0	2
OG0009136	2	0	0	0	0	0	2
OG0009137	2	0	0	0	0	0	2
OG0009138	2	0	0	0	0	0	2
OG0009139	1	0	0	0	1	0	2
OG0009140	2	0	0	0	0	0	2
OG0009141	2	0	0	0	0	0	2
OG0009142	2	0	0	0	0	0	2
OG0009143	2	0	0	0	0	0	2
OG0009144	2	0	0	0	0	0	2
OG0009145	2	0	0	0	0	0	2
OG0009146	1	1	0	0	0	0	2
OG0009147	2	0	0	0	0	0	2
OG0009148	2	0	0	0	0	0	2
OG0009149	2	0	0	0	0	0	2
OG0009150	2	0	0	0	0	0	2
OG0009151	2	0	0	0	0	0	2
OG0009152	2	0	0	0	0	0	2
OG0009153	1	0	1	0	0	0	2
OG0009154	2	0	0	0	0	0	2
OG0009155	2	0	0	0	0	0	2
OG0009156	2	0	0	0	0	0	2
OG0009157	2	0	0	0	0	0	2
OG0009158	2	0	0	0	0	0	2
OG0009159	2	0	0	0	0	0	2
OG0009160	2	0	0	0	0	0	2
OG0009161	2	0	0	0	0	0	2
OG0009162	1	0	1	0	0	0	2
OG0009163	2	0	0	0	0	0	2
OG0009164	1	0	1	0	0	0	2
OG0009165	2	0	0	0	0	0	2
OG0009166	2	0	0	0	0	0	2
OG0009167	2	0	0	0	0	0	2
OG0009168	2	0	0	0	0	0	2
OG0009169	2	0	0	0	0	0	2
OG0009170	2	0	0	0	0	0	2
OG0009171	2	0	0	0	0	0	2
OG0009172	1	1	0	0	0	0	2
OG0009173	1	0	0	0	1	0	2
OG0009174	2	0	0	0	0	0	2
OG0009175	2	0	0	0	0	0	2
OG0009176	2	0	0	0	0	0	2
OG0009177	2	0	0	0	0	0	2
OG0009178	1	0	1	0	0	0	2
OG0009179	2	0	0	0	0	0	2
OG0009180	2	0	0	0	0	0	2
OG0009181	2	0	0	0	0	0	2
OG0009182	2	0	0	0	0	0	2
OG0009183	2	0	0	0	0	0	2
OG0009184	1	0	1	0	0	0	2
OG0009185	2	0	0	0	0	0	2
OG0009186	2	0	0	0	0	0	2
OG0009187	2	0	0	0	0	0	2
OG0009188	2	0	0	0	0	0	2
OG0009189	2	0	0	0	0	0	2
OG0009190	2	0	0	0	0	0	2
OG0009191	2	0	0	0	0	0	2
OG0009192	2	0	0	0	0	0	2
OG0009193	2	0	0	0	0	0	2
OG0009194	2	0	0	0	0	0	2
OG0009195	2	0	0	0	0	0	2
OG0009196	2	0	0	0	0	0	2
OG0009197	2	0	0	0	0	0	2
OG0009198	2	0	0	0	0	0	2
OG0009199	2	0	0	0	0	0	2
OG0009200	2	0	0	0	0	0	2
OG0009201	2	0	0	0	0	0	2
OG0009202	2	0	0	0	0	0	2
OG0009203	2	0	0	0	0	0	2
OG0009204	2	0	0	0	0	0	2
OG0009205	2	0	0	0	0	0	2
OG0009206	2	0	0	0	0	0	2
OG0009207	1	1	0	0	0	0	2
OG0009208	2	0	0	0	0	0	2
OG0009209	2	0	0	0	0	0	2
OG0009210	2	0	0	0	0	0	2
OG0009211	2	0	0	0	0	0	2
OG0009212	2	0	0	0	0	0	2
OG0009213	2	0	0	0	0	0	2
OG0009214	2	0	0	0	0	0	2
OG0009215	2	0	0	0	0	0	2
OG0009216	2	0	0	0	0	0	2
OG0009217	2	0	0	0	0	0	2
OG0009218	2	0	0	0	0	0	2
OG0009219	2	0	0	0	0	0	2
OG0009220	2	0	0	0	0	0	2
OG0009221	2	0	0	0	0	0	2
OG0009222	2	0	0	0	0	0	2
OG0009223	1	0	1	0	0	0	2
OG0009224	1	0	1	0	0	0	2
OG0009225	2	0	0	0	0	0	2
OG0009226	2	0	0	0	0	0	2
OG0009227	2	0	0	0	0	0	2
OG0009228	2	0	0	0	0	0	2
OG0009229	2	0	0	0	0	0	2
OG0009230	2	0	0	0	0	0	2
OG0009231	1	0	1	0	0	0	2
OG0009232	2	0	0	0	0	0	2
OG0009233	2	0	0	0	0	0	2
OG0009234	2	0	0	0	0	0	2
OG0009235	1	0	1	0	0	0	2
OG0009236	2	0	0	0	0	0	2
OG0009237	2	0	0	0	0	0	2
OG0009238	2	0	0	0	0	0	2
OG0009239	1	0	1	0	0	0	2
OG0009240	1	0	1	0	0	0	2
OG0009241	2	0	0	0	0	0	2
OG0009242	2	0	0	0	0	0	2
OG0009243	2	0	0	0	0	0	2
OG0009244	2	0	0	0	0	0	2
OG0009245	2	0	0	0	0	0	2
OG0009246	2	0	0	0	0	0	2
OG0009247	2	0	0	0	0	0	2
OG0009248	2	0	0	0	0	0	2
OG0009249	2	0	0	0	0	0	2
OG0009250	2	0	0	0	0	0	2
OG0009251	1	0	1	0	0	0	2
OG0009252	2	0	0	0	0	0	2
OG0009253	2	0	0	0	0	0	2
OG0009254	2	0	0	0	0	0	2
OG0009255	2	0	0	0	0	0	2
OG0009256	2	0	0	0	0	0	2
OG0009257	2	0	0	0	0	0	2
OG0009258	2	0	0	0	0	0	2
OG0009259	2	0	0	0	0	0	2
OG0009260	2	0	0	0	0	0	2
OG0009261	2	0	0	0	0	0	2
OG0009262	2	0	0	0	0	0	2
OG0009263	1	0	0	1	0	0	2
OG0009264	2	0	0	0	0	0	2
OG0009265	1	0	1	0	0	0	2
OG0009266	2	0	0	0	0	0	2
OG0009267	1	0	0	0	1	0	2
OG0009268	1	0	0	1	0	0	2
OG0009269	2	0	0	0	0	0	2
OG0009270	2	0	0	0	0	0	2
OG0009271	2	0	0	0	0	0	2
OG0009272	2	0	0	0	0	0	2
OG0009273	2	0	0	0	0	0	2
OG0009274	2	0	0	0	0	0	2
OG0009275	2	0	0	0	0	0	2
OG0009276	2	0	0	0	0	0	2
OG0009277	2	0	0	0	0	0	2
OG0009278	2	0	0	0	0	0	2
OG0009279	2	0	0	0	0	0	2
OG0009280	1	0	1	0	0	0	2
OG0009281	2	0	0	0	0	0	2
OG0009282	2	0	0	0	0	0	2
OG0009283	2	0	0	0	0	0	2
OG0009284	2	0	0	0	0	0	2
OG0009285	2	0	0	0	0	0	2
OG0009286	2	0	0	0	0	0	2
OG0009287	2	0	0	0	0	0	2
OG0009288	2	0	0	0	0	0	2
OG0009289	2	0	0	0	0	0	2
OG0009290	2	0	0	0	0	0	2
OG0009291	2	0	0	0	0	0	2
OG0009292	2	0	0	0	0	0	2
OG0009293	1	0	1	0	0	0	2
OG0009294	2	0	0	0	0	0	2
OG0009295	2	0	0	0	0	0	2
OG0009296	2	0	0	0	0	0	2
OG0009297	2	0	0	0	0	0	2
OG0009298	2	0	0	0	0	0	2
OG0009299	2	0	0	0	0	0	2
OG0009300	2	0	0	0	0	0	2
OG0009301	2	0	0	0	0	0	2
OG0009302	2	0	0	0	0	0	2
OG0009303	1	0	0	1	0	0	2
OG0009304	2	0	0	0	0	0	2
OG0009305	2	0	0	0	0	0	2
OG0009306	2	0	0	0	0	0	2
OG0009307	1	0	1	0	0	0	2
OG0009308	2	0	0	0	0	0	2
OG0009309	2	0	0	0	0	0	2
OG0009310	2	0	0	0	0	0	2
OG0009311	2	0	0	0	0	0	2
OG0009312	2	0	0	0	0	0	2
OG0009313	2	0	0	0	0	0	2
OG0009314	2	0	0	0	0	0	2
OG0009315	2	0	0	0	0	0	2
OG0009316	2	0	0	0	0	0	2
OG0009317	1	1	0	0	0	0	2
OG0009318	2	0	0	0	0	0	2
OG0009319	1	0	1	0	0	0	2
OG0009320	1	0	1	0	0	0	2
OG0009321	2	0	0	0	0	0	2
OG0009322	2	0	0	0	0	0	2
OG0009323	2	0	0	0	0	0	2
OG0009324	2	0	0	0	0	0	2
OG0009325	1	0	1	0	0	0	2
OG0009326	2	0	0	0	0	0	2
OG0009327	1	0	1	0	0	0	2
OG0009328	2	0	0	0	0	0	2
OG0009329	2	0	0	0	0	0	2
OG0009330	2	0	0	0	0	0	2
OG0009331	2	0	0	0	0	0	2
OG0009332	2	0	0	0	0	0	2
OG0009333	2	0	0	0	0	0	2
OG0009334	2	0	0	0	0	0	2
OG0009335	2	0	0	0	0	0	2
OG0009336	2	0	0	0	0	0	2
OG0009337	2	0	0	0	0	0	2
OG0009338	2	0	0	0	0	0	2
OG0009339	2	0	0	0	0	0	2
OG0009340	2	0	0	0	0	0	2
OG0009341	1	0	1	0	0	0	2
OG0009342	2	0	0	0	0	0	2
OG0009343	1	1	0	0	0	0	2
OG0009344	2	0	0	0	0	0	2
OG0009345	2	0	0	0	0	0	2
OG0009346	2	0	0	0	0	0	2
OG0009347	2	0	0	0	0	0	2
OG0009348	2	0	0	0	0	0	2
OG0009349	2	0	0	0	0	0	2
OG0009350	1	0	1	0	0	0	2
OG0009351	1	0	0	1	0	0	2
OG0009352	2	0	0	0	0	0	2
OG0009353	1	0	1	0	0	0	2
OG0009354	1	0	1	0	0	0	2
OG0009355	2	0	0	0	0	0	2
OG0009356	2	0	0	0	0	0	2
OG0009357	2	0	0	0	0	0	2
OG0009358	2	0	0	0	0	0	2
OG0009359	1	0	1	0	0	0	2
OG0009360	2	0	0	0	0	0	2
OG0009361	2	0	0	0	0	0	2
OG0009362	2	0	0	0	0	0	2
OG0009363	2	0	0	0	0	0	2
OG0009364	2	0	0	0	0	0	2
OG0009365	1	0	0	1	0	0	2
OG0009366	2	0	0	0	0	0	2
OG0009367	1	1	0	0	0	0	2
OG0009368	1	0	1	0	0	0	2
OG0009369	2	0	0	0	0	0	2
OG0009370	1	0	1	0	0	0	2
OG0009371	2	0	0	0	0	0	2
OG0009372	1	0	1	0	0	0	2
OG0009373	2	0	0	0	0	0	2
OG0009374	2	0	0	0	0	0	2
OG0009375	2	0	0	0	0	0	2
OG0009376	2	0	0	0	0	0	2
OG0009377	2	0	0	0	0	0	2
OG0009378	2	0	0	0	0	0	2
OG0009379	2	0	0	0	0	0	2
OG0009380	2	0	0	0	0	0	2
OG0009381	2	0	0	0	0	0	2
OG0009382	2	0	0	0	0	0	2
OG0009383	2	0	0	0	0	0	2
OG0009384	2	0	0	0	0	0	2
OG0009385	2	0	0	0	0	0	2
OG0009386	2	0	0	0	0	0	2
OG0009387	2	0	0	0	0	0	2
OG0009388	2	0	0	0	0	0	2
OG0009389	2	0	0	0	0	0	2
OG0009390	2	0	0	0	0	0	2
OG0009391	2	0	0	0	0	0	2
OG0009392	2	0	0	0	0	0	2
OG0009393	2	0	0	0	0	0	2
OG0009394	2	0	0	0	0	0	2
OG0009395	2	0	0	0	0	0	2
OG0009396	2	0	0	0	0	0	2
OG0009397	2	0	0	0	0	0	2
OG0009398	2	0	0	0	0	0	2
OG0009399	2	0	0	0	0	0	2
OG0009400	2	0	0	0	0	0	2
OG0009401	2	0	0	0	0	0	2
OG0009402	2	0	0	0	0	0	2
OG0009403	2	0	0	0	0	0	2
OG0009404	2	0	0	0	0	0	2
OG0009405	2	0	0	0	0	0	2
OG0009406	2	0	0	0	0	0	2
OG0009407	2	0	0	0	0	0	2
OG0009408	1	0	1	0	0	0	2
OG0009409	2	0	0	0	0	0	2
OG0009410	2	0	0	0	0	0	2
OG0009411	2	0	0	0	0	0	2
OG0009412	1	0	1	0	0	0	2
OG0009413	2	0	0	0	0	0	2
OG0009414	2	0	0	0	0	0	2
OG0009415	2	0	0	0	0	0	2
OG0009416	2	0	0	0	0	0	2
OG0009417	2	0	0	0	0	0	2
OG0009418	2	0	0	0	0	0	2
OG0009419	2	0	0	0	0	0	2
OG0009420	2	0	0	0	0	0	2
OG0009421	2	0	0	0	0	0	2
OG0009422	1	0	0	1	0	0	2
OG0009423	1	0	1	0	0	0	2
OG0009424	1	0	1	0	0	0	2
OG0009425	2	0	0	0	0	0	2
OG0009426	2	0	0	0	0	0	2
OG0009427	2	0	0	0	0	0	2
OG0009428	2	0	0	0	0	0	2
OG0009429	1	1	0	0	0	0	2
OG0009430	2	0	0	0	0	0	2
OG0009431	2	0	0	0	0	0	2
OG0009432	1	0	0	0	0	1	2
OG0009433	1	0	1	0	0	0	2
OG0009434	2	0	0	0	0	0	2
OG0009435	2	0	0	0	0	0	2
OG0009436	2	0	0	0	0	0	2
OG0009437	2	0	0	0	0	0	2
OG0009438	2	0	0	0	0	0	2
OG0009439	1	0	1	0	0	0	2
OG0009440	2	0	0	0	0	0	2
OG0009441	2	0	0	0	0	0	2
OG0009442	2	0	0	0	0	0	2
OG0009443	2	0	0	0	0	0	2
OG0009444	2	0	0	0	0	0	2
OG0009445	2	0	0	0	0	0	2
OG0009446	2	0	0	0	0	0	2
OG0009447	2	0	0	0	0	0	2
OG0009448	1	0	1	0	0	0	2
OG0009449	2	0	0	0	0	0	2
OG0009450	2	0	0	0	0	0	2
OG0009451	2	0	0	0	0	0	2
OG0009452	2	0	0	0	0	0	2
OG0009453	2	0	0	0	0	0	2
OG0009454	2	0	0	0	0	0	2
OG0009455	2	0	0	0	0	0	2
OG0009456	1	0	1	0	0	0	2
OG0009457	2	0	0	0	0	0	2
OG0009458	2	0	0	0	0	0	2
OG0009459	2	0	0	0	0	0	2
OG0009460	2	0	0	0	0	0	2
OG0009461	2	0	0	0	0	0	2
OG0009462	2	0	0	0	0	0	2
OG0009463	1	0	1	0	0	0	2
OG0009464	2	0	0	0	0	0	2
OG0009465	2	0	0	0	0	0	2
OG0009466	2	0	0	0	0	0	2
OG0009467	2	0	0	0	0	0	2
OG0009468	2	0	0	0	0	0	2
OG0009469	2	0	0	0	0	0	2
OG0009470	2	0	0	0	0	0	2
OG0009471	2	0	0	0	0	0	2
OG0009472	2	0	0	0	0	0	2
OG0009473	2	0	0	0	0	0	2
OG0009474	2	0	0	0	0	0	2
OG0009475	2	0	0	0	0	0	2
OG0009476	2	0	0	0	0	0	2
OG0009477	2	0	0	0	0	0	2
OG0009478	2	0	0	0	0	0	2
OG0009479	2	0	0	0	0	0	2
OG0009480	1	0	1	0	0	0	2
OG0009481	2	0	0	0	0	0	2
OG0009482	2	0	0	0	0	0	2
OG0009483	2	0	0	0	0	0	2
OG0009484	1	1	0	0	0	0	2
OG0009485	2	0	0	0	0	0	2
OG0009486	2	0	0	0	0	0	2
OG0009487	2	0	0	0	0	0	2
OG0009488	2	0	0	0	0	0	2
OG0009489	2	0	0	0	0	0	2
OG0009490	2	0	0	0	0	0	2
OG0009491	2	0	0	0	0	0	2
OG0009492	2	0	0	0	0	0	2
OG0009493	2	0	0	0	0	0	2
OG0009494	1	0	1	0	0	0	2
OG0009495	2	0	0	0	0	0	2
OG0009496	2	0	0	0	0	0	2
OG0009497	1	0	1	0	0	0	2
OG0009498	2	0	0	0	0	0	2
OG0009499	2	0	0	0	0	0	2
OG0009500	2	0	0	0	0	0	2
OG0009501	2	0	0	0	0	0	2
OG0009502	1	0	1	0	0	0	2
OG0009503	2	0	0	0	0	0	2
OG0009504	2	0	0	0	0	0	2
OG0009505	2	0	0	0	0	0	2
OG0009506	2	0	0	0	0	0	2
OG0009507	1	0	0	0	1	0	2
OG0009508	2	0	0	0	0	0	2
OG0009509	2	0	0	0	0	0	2
OG0009510	2	0	0	0	0	0	2
OG0009511	2	0	0	0	0	0	2
OG0009512	2	0	0	0	0	0	2
OG0009513	2	0	0	0	0	0	2
OG0009514	2	0	0	0	0	0	2
OG0009515	2	0	0	0	0	0	2
OG0009516	2	0	0	0	0	0	2
OG0009517	2	0	0	0	0	0	2
OG0009518	2	0	0	0	0	0	2
OG0009519	2	0	0	0	0	0	2
OG0009520	2	0	0	0	0	0	2
OG0009521	2	0	0	0	0	0	2
OG0009522	2	0	0	0	0	0	2
OG0009523	2	0	0	0	0	0	2
OG0009524	2	0	0	0	0	0	2
OG0009525	2	0	0	0	0	0	2
OG0009526	2	0	0	0	0	0	2
OG0009527	2	0	0	0	0	0	2
OG0009528	2	0	0	0	0	0	2
OG0009529	1	1	0	0	0	0	2
OG0009530	2	0	0	0	0	0	2
OG0009531	2	0	0	0	0	0	2
OG0009532	2	0	0	0	0	0	2
OG0009533	2	0	0	0	0	0	2
OG0009534	2	0	0	0	0	0	2
OG0009535	2	0	0	0	0	0	2
OG0009536	2	0	0	0	0	0	2
OG0009537	1	0	1	0	0	0	2
OG0009538	2	0	0	0	0	0	2
OG0009539	2	0	0	0	0	0	2
OG0009540	2	0	0	0	0	0	2
OG0009541	2	0	0	0	0	0	2
OG0009542	2	0	0	0	0	0	2
OG0009543	2	0	0	0	0	0	2
OG0009544	2	0	0	0	0	0	2
OG0009545	1	0	1	0	0	0	2
OG0009546	1	0	1	0	0	0	2
OG0009547	2	0	0	0	0	0	2
OG0009548	2	0	0	0	0	0	2
OG0009549	2	0	0	0	0	0	2
OG0009550	2	0	0	0	0	0	2
OG0009551	2	0	0	0	0	0	2
OG0009552	2	0	0	0	0	0	2
OG0009553	2	0	0	0	0	0	2
OG0009554	2	0	0	0	0	0	2
OG0009555	2	0	0	0	0	0	2
OG0009556	2	0	0	0	0	0	2
OG0009557	1	0	1	0	0	0	2
OG0009558	1	0	1	0	0	0	2
OG0009559	2	0	0	0	0	0	2
OG0009560	1	0	1	0	0	0	2
OG0009561	2	0	0	0	0	0	2
OG0009562	2	0	0	0	0	0	2
OG0009563	2	0	0	0	0	0	2
OG0009564	2	0	0	0	0	0	2
OG0009565	2	0	0	0	0	0	2
OG0009566	2	0	0	0	0	0	2
OG0009567	2	0	0	0	0	0	2
OG0009568	2	0	0	0	0	0	2
OG0009569	2	0	0	0	0	0	2
OG0009570	2	0	0	0	0	0	2
OG0009571	2	0	0	0	0	0	2
OG0009572	2	0	0	0	0	0	2
OG0009573	1	0	1	0	0	0	2
OG0009574	1	0	0	1	0	0	2
OG0009575	2	0	0	0	0	0	2
OG0009576	1	0	0	1	0	0	2
OG0009577	1	0	0	1	0	0	2
OG0009578	2	0	0	0	0	0	2
OG0009579	2	0	0	0	0	0	2
OG0009580	2	0	0	0	0	0	2
OG0009581	2	0	0	0	0	0	2
OG0009582	2	0	0	0	0	0	2
OG0009583	2	0	0	0	0	0	2
OG0009584	2	0	0	0	0	0	2
OG0009585	1	0	1	0	0	0	2
OG0009586	1	1	0	0	0	0	2
OG0009587	1	1	0	0	0	0	2
OG0009588	2	0	0	0	0	0	2
OG0009589	2	0	0	0	0	0	2
OG0009590	2	0	0	0	0	0	2
OG0009591	2	0	0	0	0	0	2
OG0009592	2	0	0	0	0	0	2
OG0009593	2	0	0	0	0	0	2
OG0009594	2	0	0	0	0	0	2
OG0009595	2	0	0	0	0	0	2
OG0009596	2	0	0	0	0	0	2
OG0009597	2	0	0	0	0	0	2
OG0009598	2	0	0	0	0	0	2
OG0009599	2	0	0	0	0	0	2
OG0009600	2	0	0	0	0	0	2
OG0009601	2	0	0	0	0	0	2
OG0009602	2	0	0	0	0	0	2
OG0009603	2	0	0	0	0	0	2
OG0009604	2	0	0	0	0	0	2
OG0009605	2	0	0	0	0	0	2
OG0009606	2	0	0	0	0	0	2
OG0009607	1	0	1	0	0	0	2
OG0009608	2	0	0	0	0	0	2
OG0009609	2	0	0	0	0	0	2
OG0009610	2	0	0	0	0	0	2
OG0009611	1	0	0	0	0	1	2
OG0009612	2	0	0	0	0	0	2
OG0009613	2	0	0	0	0	0	2
OG0009614	2	0	0	0	0	0	2
OG0009615	2	0	0	0	0	0	2
OG0009616	2	0	0	0	0	0	2
OG0009617	2	0	0	0	0	0	2
OG0009618	1	0	0	0	0	1	2
OG0009619	1	0	1	0	0	0	2
OG0009620	1	0	0	1	0	0	2
OG0009621	1	0	1	0	0	0	2
OG0009622	2	0	0	0	0	0	2
OG0009623	2	0	0	0	0	0	2
OG0009624	2	0	0	0	0	0	2
OG0009625	2	0	0	0	0	0	2
OG0009626	2	0	0	0	0	0	2
OG0009627	1	0	1	0	0	0	2
OG0009628	1	0	1	0	0	0	2
OG0009629	1	0	1	0	0	0	2
OG0009630	1	0	0	0	0	1	2
OG0009631	2	0	0	0	0	0	2
OG0009632	1	0	1	0	0	0	2
OG0009633	2	0	0	0	0	0	2
OG0009634	1	0	0	1	0	0	2
OG0009635	2	0	0	0	0	0	2
OG0009636	2	0	0	0	0	0	2
OG0009637	1	0	1	0	0	0	2
OG0009638	1	0	1	0	0	0	2
OG0009639	1	1	0	0	0	0	2
OG0009640	1	0	0	1	0	0	2
OG0009641	2	0	0	0	0	0	2
OG0009642	1	0	0	1	0	0	2
OG0009643	1	0	1	0	0	0	2
OG0009644	2	0	0	0	0	0	2
OG0009645	2	0	0	0	0	0	2
OG0009646	2	0	0	0	0	0	2
OG0009647	2	0	0	0	0	0	2
OG0009648	1	1	0	0	0	0	2
OG0009649	1	0	1	0	0	0	2
OG0009650	2	0	0	0	0	0	2
OG0009651	2	0	0	0	0	0	2
OG0009652	2	0	0	0	0	0	2
OG0009653	2	0	0	0	0	0	2
OG0009654	2	0	0	0	0	0	2
OG0009655	2	0	0	0	0	0	2
OG0009656	2	0	0	0	0	0	2
OG0009657	1	0	1	0	0	0	2
OG0009658	2	0	0	0	0	0	2
OG0009659	2	0	0	0	0	0	2
OG0009660	2	0	0	0	0	0	2
OG0009661	2	0	0	0	0	0	2
OG0009662	2	0	0	0	0	0	2
OG0009663	2	0	0	0	0	0	2
OG0009664	2	0	0	0	0	0	2
OG0009665	2	0	0	0	0	0	2
OG0009666	2	0	0	0	0	0	2
OG0009667	1	1	0	0	0	0	2
OG0009668	2	0	0	0	0	0	2
OG0009669	2	0	0	0	0	0	2
OG0009670	2	0	0	0	0	0	2
OG0009671	2	0	0	0	0	0	2
OG0009672	2	0	0	0	0	0	2
OG0009673	2	0	0	0	0	0	2
OG0009674	2	0	0	0	0	0	2
OG0009675	2	0	0	0	0	0	2
OG0009676	2	0	0	0	0	0	2
OG0009677	1	0	1	0	0	0	2
OG0009678	1	0	1	0	0	0	2
OG0009679	2	0	0	0	0	0	2
OG0009680	2	0	0	0	0	0	2
OG0009681	2	0	0	0	0	0	2
OG0009682	1	0	0	1	0	0	2
OG0009683	2	0	0	0	0	0	2
OG0009684	1	1	0	0	0	0	2
OG0009685	2	0	0	0	0	0	2
OG0009686	2	0	0	0	0	0	2
OG0009687	2	0	0	0	0	0	2
OG0009688	2	0	0	0	0	0	2
OG0009689	2	0	0	0	0	0	2
OG0009690	2	0	0	0	0	0	2
OG0009691	1	0	1	0	0	0	2
OG0009692	2	0	0	0	0	0	2
OG0009693	2	0	0	0	0	0	2
OG0009694	2	0	0	0	0	0	2
OG0009695	2	0	0	0	0	0	2
OG0009696	2	0	0	0	0	0	2
OG0009697	2	0	0	0	0	0	2
OG0009698	2	0	0	0	0	0	2
OG0009699	2	0	0	0	0	0	2
OG0009700	1	0	1	0	0	0	2
OG0009701	1	0	1	0	0	0	2
OG0009702	2	0	0	0	0	0	2
OG0009703	2	0	0	0	0	0	2
OG0009704	2	0	0	0	0	0	2
OG0009705	2	0	0	0	0	0	2
OG0009706	2	0	0	0	0	0	2
OG0009707	2	0	0	0	0	0	2
OG0009708	2	0	0	0	0	0	2
OG0009709	2	0	0	0	0	0	2
OG0009710	2	0	0	0	0	0	2
OG0009711	2	0	0	0	0	0	2
OG0009712	2	0	0	0	0	0	2
OG0009713	1	0	1	0	0	0	2
OG0009714	1	0	1	0	0	0	2
OG0009715	1	0	1	0	0	0	2
OG0009716	1	0	0	0	1	0	2
OG0009717	1	1	0	0	0	0	2
OG0009718	2	0	0	0	0	0	2
OG0009719	2	0	0	0	0	0	2
OG0009720	2	0	0	0	0	0	2
OG0009721	2	0	0	0	0	0	2
OG0009722	2	0	0	0	0	0	2
OG0009723	2	0	0	0	0	0	2
OG0009724	2	0	0	0	0	0	2
OG0009725	2	0	0	0	0	0	2
OG0009726	1	1	0	0	0	0	2
OG0009727	1	0	1	0	0	0	2
OG0009728	1	0	1	0	0	0	2
OG0009729	2	0	0	0	0	0	2
OG0009730	2	0	0	0	0	0	2
OG0009731	2	0	0	0	0	0	2
OG0009732	1	0	1	0	0	0	2
OG0009733	2	0	0	0	0	0	2
OG0009734	1	1	0	0	0	0	2
OG0009735	2	0	0	0	0	0	2
OG0009736	2	0	0	0	0	0	2
OG0009737	2	0	0	0	0	0	2
OG0009738	2	0	0	0	0	0	2
OG0009739	2	0	0	0	0	0	2
OG0009740	2	0	0	0	0	0	2
OG0009741	2	0	0	0	0	0	2
OG0009742	2	0	0	0	0	0	2
OG0009743	2	0	0	0	0	0	2
OG0009744	2	0	0	0	0	0	2
OG0009745	2	0	0	0	0	0	2
OG0009746	2	0	0	0	0	0	2
OG0009747	2	0	0	0	0	0	2
OG0009748	2	0	0	0	0	0	2
OG0009749	2	0	0	0	0	0	2
OG0009750	2	0	0	0	0	0	2
OG0009751	2	0	0	0	0	0	2
OG0009752	2	0	0	0	0	0	2
OG0009753	2	0	0	0	0	0	2
OG0009754	2	0	0	0	0	0	2
OG0009755	1	0	0	1	0	0	2
OG0009756	2	0	0	0	0	0	2
OG0009757	2	0	0	0	0	0	2
OG0009758	2	0	0	0	0	0	2
OG0009759	2	0	0	0	0	0	2
OG0009760	1	0	0	0	0	1	2
OG0009761	1	0	1	0	0	0	2
OG0009762	2	0	0	0	0	0	2
OG0009763	2	0	0	0	0	0	2
OG0009764	2	0	0	0	0	0	2
OG0009765	2	0	0	0	0	0	2
OG0009766	2	0	0	0	0	0	2
OG0009767	1	0	0	0	1	0	2
OG0009768	2	0	0	0	0	0	2
OG0009769	2	0	0	0	0	0	2
OG0009770	1	0	1	0	0	0	2
OG0009771	1	0	1	0	0	0	2
OG0009772	1	0	0	1	0	0	2
OG0009773	1	0	1	0	0	0	2
OG0009774	1	0	0	1	0	0	2
OG0009775	2	0	0	0	0	0	2
OG0009776	1	0	1	0	0	0	2
OG0009777	2	0	0	0	0	0	2
OG0009778	2	0	0	0	0	0	2
OG0009779	2	0	0	0	0	0	2
OG0009780	2	0	0	0	0	0	2
OG0009781	2	0	0	0	0	0	2
OG0009782	2	0	0	0	0	0	2
OG0009783	2	0	0	0	0	0	2
OG0009784	2	0	0	0	0	0	2
OG0009785	2	0	0	0	0	0	2
OG0009786	2	0	0	0	0	0	2
OG0009787	1	0	0	0	1	0	2
OG0009788	1	0	1	0	0	0	2
OG0009789	2	0	0	0	0	0	2
OG0009790	2	0	0	0	0	0	2
OG0009791	2	0	0	0	0	0	2
OG0009792	2	0	0	0	0	0	2
OG0009793	2	0	0	0	0	0	2
OG0009794	2	0	0	0	0	0	2
OG0009795	2	0	0	0	0	0	2
OG0009796	2	0	0	0	0	0	2
OG0009797	2	0	0	0	0	0	2
OG0009798	1	1	0	0	0	0	2
OG0009799	2	0	0	0	0	0	2
OG0009800	1	0	1	0	0	0	2
OG0009801	2	0	0	0	0	0	2
OG0009802	2	0	0	0	0	0	2
OG0009803	2	0	0	0	0	0	2
OG0009804	1	0	1	0	0	0	2
OG0009805	2	0	0	0	0	0	2
OG0009806	2	0	0	0	0	0	2
OG0009807	2	0	0	0	0	0	2
OG0009808	2	0	0	0	0	0	2
OG0009809	1	0	1	0	0	0	2
OG0009810	2	0	0	0	0	0	2
OG0009811	2	0	0	0	0	0	2
OG0009812	2	0	0	0	0	0	2
OG0009813	2	0	0	0	0	0	2
OG0009814	2	0	0	0	0	0	2
OG0009815	1	1	0	0	0	0	2
OG0009816	1	0	0	1	0	0	2
OG0009817	1	0	1	0	0	0	2
OG0009818	1	1	0	0	0	0	2
OG0009819	1	0	1	0	0	0	2
OG0009820	2	0	0	0	0	0	2
OG0009821	2	0	0	0	0	0	2
OG0009822	2	0	0	0	0	0	2
OG0009823	1	0	1	0	0	0	2
OG0009824	2	0	0	0	0	0	2
OG0009825	2	0	0	0	0	0	2
OG0009826	2	0	0	0	0	0	2
OG0009827	2	0	0	0	0	0	2
OG0009828	1	0	1	0	0	0	2
OG0009829	1	0	1	0	0	0	2
OG0009830	1	1	0	0	0	0	2
OG0009831	2	0	0	0	0	0	2
OG0009832	2	0	0	0	0	0	2
OG0009833	2	0	0	0	0	0	2
OG0009834	2	0	0	0	0	0	2
OG0009835	2	0	0	0	0	0	2
OG0009836	2	0	0	0	0	0	2
OG0009837	2	0	0	0	0	0	2
OG0009838	1	1	0	0	0	0	2
OG0009839	2	0	0	0	0	0	2
OG0009840	2	0	0	0	0	0	2
OG0009841	1	0	1	0	0	0	2
OG0009842	2	0	0	0	0	0	2
OG0009843	2	0	0	0	0	0	2
OG0009844	2	0	0	0	0	0	2
OG0009845	2	0	0	0	0	0	2
OG0009846	2	0	0	0	0	0	2
OG0009847	2	0	0	0	0	0	2
OG0009848	2	0	0	0	0	0	2
OG0009849	2	0	0	0	0	0	2
OG0009850	2	0	0	0	0	0	2
OG0009851	2	0	0	0	0	0	2
OG0009852	1	0	0	0	0	1	2
OG0009853	2	0	0	0	0	0	2
OG0009854	1	0	0	1	0	0	2
OG0009855	1	0	1	0	0	0	2
OG0009856	2	0	0	0	0	0	2
OG0009857	2	0	0	0	0	0	2
OG0009858	2	0	0	0	0	0	2
OG0009859	2	0	0	0	0	0	2
OG0009860	2	0	0	0	0	0	2
OG0009861	1	1	0	0	0	0	2
OG0009862	2	0	0	0	0	0	2
OG0009863	2	0	0	0	0	0	2
OG0009864	2	0	0	0	0	0	2
OG0009865	2	0	0	0	0	0	2
OG0009866	2	0	0	0	0	0	2
OG0009867	1	0	1	0	0	0	2
OG0009868	1	0	0	0	1	0	2
OG0009869	2	0	0	0	0	0	2
OG0009870	2	0	0	0	0	0	2
OG0009871	1	0	1	0	0	0	2
OG0009872	1	1	0	0	0	0	2
OG0009873	1	1	0	0	0	0	2
OG0009874	2	0	0	0	0	0	2
OG0009875	2	0	0	0	0	0	2
OG0009876	2	0	0	0	0	0	2
OG0009877	2	0	0	0	0	0	2
OG0009878	2	0	0	0	0	0	2
OG0009879	2	0	0	0	0	0	2
OG0009880	2	0	0	0	0	0	2
OG0009881	2	0	0	0	0	0	2
OG0009882	1	0	1	0	0	0	2
OG0009883	2	0	0	0	0	0	2
OG0009884	1	0	1	0	0	0	2
OG0009885	2	0	0	0	0	0	2
OG0009886	2	0	0	0	0	0	2
OG0009887	1	0	1	0	0	0	2
OG0009888	2	0	0	0	0	0	2
OG0009889	1	0	0	0	1	0	2
OG0009890	2	0	0	0	0	0	2
OG0009891	1	0	1	0	0	0	2
OG0009892	2	0	0	0	0	0	2
OG0009893	2	0	0	0	0	0	2
OG0009894	2	0	0	0	0	0	2
OG0009895	1	0	0	1	0	0	2
OG0009896	2	0	0	0	0	0	2
OG0009897	2	0	0	0	0	0	2
OG0009898	2	0	0	0	0	0	2
OG0009899	2	0	0	0	0	0	2
OG0009900	2	0	0	0	0	0	2
OG0009901	2	0	0	0	0	0	2
OG0009902	2	0	0	0	0	0	2
OG0009903	2	0	0	0	0	0	2
OG0009904	2	0	0	0	0	0	2
OG0009905	2	0	0	0	0	0	2
OG0009906	2	0	0	0	0	0	2
OG0009907	2	0	0	0	0	0	2
OG0009908	1	0	1	0	0	0	2
OG0009909	1	0	1	0	0	0	2
OG0009910	2	0	0	0	0	0	2
OG0009911	2	0	0	0	0	0	2
OG0009912	2	0	0	0	0	0	2
OG0009913	1	1	0	0	0	0	2
OG0009914	2	0	0	0	0	0	2
OG0009915	2	0	0	0	0	0	2
OG0009916	2	0	0	0	0	0	2
OG0009917	2	0	0	0	0	0	2
OG0009918	2	0	0	0	0	0	2
OG0009919	2	0	0	0	0	0	2
OG0009920	1	0	1	0	0	0	2
OG0009921	2	0	0	0	0	0	2
OG0009922	2	0	0	0	0	0	2
OG0009923	1	1	0	0	0	0	2
OG0009924	2	0	0	0	0	0	2
OG0009925	2	0	0	0	0	0	2
OG0009926	2	0	0	0	0	0	2
OG0009927	2	0	0	0	0	0	2
OG0009928	2	0	0	0	0	0	2
OG0009929	2	0	0	0	0	0	2
OG0009930	2	0	0	0	0	0	2
OG0009931	2	0	0	0	0	0	2
OG0009932	2	0	0	0	0	0	2
OG0009933	2	0	0	0	0	0	2
OG0009934	1	0	1	0	0	0	2
OG0009935	2	0	0	0	0	0	2
OG0009936	2	0	0	0	0	0	2
OG0009937	2	0	0	0	0	0	2
OG0009938	2	0	0	0	0	0	2
OG0009939	2	0	0	0	0	0	2
OG0009940	2	0	0	0	0	0	2
OG0009941	1	0	0	1	0	0	2
OG0009942	2	0	0	0	0	0	2
OG0009943	1	0	1	0	0	0	2
OG0009944	1	0	1	0	0	0	2
OG0009945	2	0	0	0	0	0	2
OG0009946	1	0	0	1	0	0	2
OG0009947	1	0	1	0	0	0	2
OG0009948	2	0	0	0	0	0	2
OG0009949	2	0	0	0	0	0	2
OG0009950	1	0	0	1	0	0	2
OG0009951	1	0	1	0	0	0	2
OG0009952	2	0	0	0	0	0	2
OG0009953	2	0	0	0	0	0	2
OG0009954	1	1	0	0	0	0	2
OG0009955	2	0	0	0	0	0	2
OG0009956	2	0	0	0	0	0	2
OG0009957	1	0	1	0	0	0	2
OG0009958	1	0	1	0	0	0	2
OG0009959	2	0	0	0	0	0	2
OG0009960	1	0	1	0	0	0	2
OG0009961	2	0	0	0	0	0	2
OG0009962	2	0	0	0	0	0	2
OG0009963	1	0	1	0	0	0	2
OG0009964	2	0	0	0	0	0	2
OG0009965	2	0	0	0	0	0	2
OG0009966	2	0	0	0	0	0	2
OG0009967	2	0	0	0	0	0	2
OG0009968	2	0	0	0	0	0	2
OG0009969	1	0	1	0	0	0	2
OG0009970	2	0	0	0	0	0	2
OG0009971	2	0	0	0	0	0	2
OG0009972	1	0	0	0	1	0	2
OG0009973	1	0	1	0	0	0	2
OG0009974	2	0	0	0	0	0	2
OG0009975	1	0	0	0	0	1	2
OG0009976	1	0	1	0	0	0	2
OG0009977	1	0	1	0	0	0	2
OG0009978	1	1	0	0	0	0	2
OG0009979	1	0	1	0	0	0	2
OG0009980	1	0	1	0	0	0	2
OG0009981	1	0	0	1	0	0	2
OG0009982	1	0	1	0	0	0	2
OG0009983	1	0	1	0	0	0	2
OG0009984	1	1	0	0	0	0	2
OG0009985	2	0	0	0	0	0	2
OG0009986	1	0	1	0	0	0	2
OG0009987	2	0	0	0	0	0	2
OG0009988	2	0	0	0	0	0	2
OG0009989	2	0	0	0	0	0	2
OG0009990	2	0	0	0	0	0	2
OG0009991	2	0	0	0	0	0	2
OG0009992	1	0	1	0	0	0	2
OG0009993	2	0	0	0	0	0	2
OG0009994	2	0	0	0	0	0	2
OG0009995	1	0	1	0	0	0	2
OG0009996	1	0	1	0	0	0	2
OG0009997	1	0	1	0	0	0	2
OG0009998	2	0	0	0	0	0	2
OG0009999	2	0	0	0	0	0	2
OG0010000	2	0	0	0	0	0	2
OG0010001	2	0	0	0	0	0	2
OG0010002	2	0	0	0	0	0	2
OG0010003	1	1	0	0	0	0	2
OG0010004	2	0	0	0	0	0	2
OG0010005	1	0	0	0	1	0	2
OG0010006	1	0	0	1	0	0	2
OG0010007	2	0	0	0	0	0	2
OG0010008	2	0	0	0	0	0	2
OG0010009	2	0	0	0	0	0	2
OG0010010	2	0	0	0	0	0	2
OG0010011	2	0	0	0	0	0	2
OG0010012	2	0	0	0	0	0	2
OG0010013	2	0	0	0	0	0	2
OG0010014	2	0	0	0	0	0	2
OG0010015	2	0	0	0	0	0	2
OG0010016	2	0	0	0	0	0	2
OG0010017	2	0	0	0	0	0	2
OG0010018	2	0	0	0	0	0	2
OG0010019	2	0	0	0	0	0	2
OG0010020	2	0	0	0	0	0	2
OG0010021	2	0	0	0	0	0	2
OG0010022	2	0	0	0	0	0	2
OG0010023	2	0	0	0	0	0	2
OG0010024	1	0	0	1	0	0	2
OG0010025	1	0	1	0	0	0	2
OG0010026	2	0	0	0	0	0	2
OG0010027	1	0	0	1	0	0	2
OG0010028	2	0	0	0	0	0	2
OG0010029	1	0	0	0	0	1	2
OG0010030	2	0	0	0	0	0	2
OG0010031	1	1	0	0	0	0	2
OG0010032	1	0	0	1	0	0	2
OG0010033	1	0	1	0	0	0	2
OG0010034	2	0	0	0	0	0	2
OG0010035	2	0	0	0	0	0	2
OG0010036	1	0	1	0	0	0	2
OG0010037	2	0	0	0	0	0	2
OG0010038	2	0	0	0	0	0	2
OG0010039	2	0	0	0	0	0	2
OG0010040	2	0	0	0	0	0	2
OG0010041	1	0	0	0	1	0	2
OG0010042	1	0	0	1	0	0	2
OG0010043	1	0	1	0	0	0	2
OG0010044	2	0	0	0	0	0	2
OG0010045	1	0	0	1	0	0	2
OG0010046	1	0	1	0	0	0	2
OG0010047	1	0	1	0	0	0	2
OG0010048	1	0	1	0	0	0	2
OG0010049	2	0	0	0	0	0	2
OG0010050	1	0	1	0	0	0	2
OG0010051	2	0	0	0	0	0	2
OG0010052	1	0	1	0	0	0	2
OG0010053	2	0	0	0	0	0	2
OG0010054	1	0	1	0	0	0	2
OG0010055	1	0	1	0	0	0	2
OG0010056	1	0	0	0	1	0	2
OG0010057	1	0	1	0	0	0	2
OG0010058	1	0	1	0	0	0	2
OG0010059	1	0	1	0	0	0	2
OG0010060	1	1	0	0	0	0	2
OG0010061	1	0	1	0	0	0	2
OG0010062	2	0	0	0	0	0	2
OG0010063	1	0	1	0	0	0	2
OG0010064	2	0	0	0	0	0	2
OG0010065	2	0	0	0	0	0	2
OG0010066	2	0	0	0	0	0	2
OG0010067	2	0	0	0	0	0	2
OG0010068	1	1	0	0	0	0	2
OG0010069	1	1	0	0	0	0	2
OG0010070	2	0	0	0	0	0	2
OG0010071	2	0	0	0	0	0	2
OG0010072	2	0	0	0	0	0	2
OG0010073	2	0	0	0	0	0	2
OG0010074	2	0	0	0	0	0	2
OG0010075	2	0	0	0	0	0	2
OG0010076	1	0	1	0	0	0	2
OG0010077	1	0	1	0	0	0	2
OG0010078	2	0	0	0	0	0	2
OG0010079	1	1	0	0	0	0	2
OG0010080	2	0	0	0	0	0	2
OG0010081	2	0	0	0	0	0	2
OG0010082	2	0	0	0	0	0	2
OG0010083	2	0	0	0	0	0	2
OG0010084	2	0	0	0	0	0	2
OG0010085	2	0	0	0	0	0	2
OG0010086	1	0	0	1	0	0	2
OG0010087	1	0	1	0	0	0	2
OG0010088	1	1	0	0	0	0	2
OG0010089	2	0	0	0	0	0	2
OG0010090	2	0	0	0	0	0	2
OG0010091	2	0	0	0	0	0	2
OG0010092	2	0	0	0	0	0	2
OG0010093	2	0	0	0	0	0	2
OG0010094	1	0	1	0	0	0	2
OG0010095	1	0	1	0	0	0	2
OG0010096	2	0	0	0	0	0	2
OG0010097	1	0	1	0	0	0	2
OG0010098	1	1	0	0	0	0	2
OG0010099	2	0	0	0	0	0	2
OG0010100	2	0	0	0	0	0	2
OG0010101	2	0	0	0	0	0	2
OG0010102	1	0	1	0	0	0	2
OG0010103	2	0	0	0	0	0	2
OG0010104	2	0	0	0	0	0	2
OG0010105	2	0	0	0	0	0	2
OG0010106	2	0	0	0	0	0	2
OG0010107	2	0	0	0	0	0	2
OG0010108	2	0	0	0	0	0	2
OG0010109	2	0	0	0	0	0	2
OG0010110	2	0	0	0	0	0	2
OG0010111	1	0	0	0	1	0	2
OG0010112	2	0	0	0	0	0	2
OG0010113	1	1	0	0	0	0	2
OG0010114	2	0	0	0	0	0	2
OG0010115	2	0	0	0	0	0	2
OG0010116	2	0	0	0	0	0	2
OG0010117	2	0	0	0	0	0	2
OG0010118	2	0	0	0	0	0	2
OG0010119	1	0	1	0	0	0	2
OG0010120	1	0	0	0	1	0	2
OG0010121	1	0	1	0	0	0	2
OG0010122	1	0	1	0	0	0	2
OG0010123	1	0	1	0	0	0	2
OG0010124	1	1	0	0	0	0	2
OG0010125	1	0	1	0	0	0	2
OG0010126	1	0	1	0	0	0	2
OG0010127	1	0	0	0	0	1	2
OG0010128	1	0	1	0	0	0	2
OG0010129	1	0	1	0	0	0	2
OG0010130	1	0	1	0	0	0	2
OG0010131	1	0	1	0	0	0	2
OG0010132	1	0	1	0	0	0	2
OG0010133	1	0	1	0	0	0	2
OG0010134	1	0	1	0	0	0	2
OG0010135	2	0	0	0	0	0	2
OG0010136	2	0	0	0	0	0	2
OG0010137	2	0	0	0	0	0	2
OG0010138	1	0	1	0	0	0	2
OG0010139	1	1	0	0	0	0	2
OG0010140	2	0	0	0	0	0	2
OG0010141	1	0	1	0	0	0	2
OG0010142	2	0	0	0	0	0	2
OG0010143	1	0	1	0	0	0	2
OG0010144	1	0	1	0	0	0	2
OG0010145	2	0	0	0	0	0	2
OG0010146	2	0	0	0	0	0	2
OG0010147	2	0	0	0	0	0	2
OG0010148	2	0	0	0	0	0	2
OG0010149	2	0	0	0	0	0	2
OG0010150	1	0	1	0	0	0	2
OG0010151	2	0	0	0	0	0	2
OG0010152	2	0	0	0	0	0	2
OG0010153	2	0	0	0	0	0	2
OG0010154	2	0	0	0	0	0	2
OG0010155	2	0	0	0	0	0	2
OG0010156	2	0	0	0	0	0	2
OG0010157	1	0	1	0	0	0	2
OG0010158	2	0	0	0	0	0	2
OG0010159	1	0	1	0	0	0	2
OG0010160	2	0	0	0	0	0	2
OG0010161	2	0	0	0	0	0	2
OG0010162	2	0	0	0	0	0	2
OG0010163	1	0	1	0	0	0	2
OG0010164	2	0	0	0	0	0	2
OG0010165	1	1	0	0	0	0	2
OG0010166	2	0	0	0	0	0	2
OG0010167	2	0	0	0	0	0	2
OG0010168	1	0	1	0	0	0	2
OG0010169	2	0	0	0	0	0	2
OG0010170	2	0	0	0	0	0	2
OG0010171	2	0	0	0	0	0	2
OG0010172	2	0	0	0	0	0	2
OG0010173	2	0	0	0	0	0	2
OG0010174	2	0	0	0	0	0	2
OG0010175	1	0	1	0	0	0	2
OG0010176	1	0	0	1	0	0	2
OG0010177	2	0	0	0	0	0	2
OG0010178	2	0	0	0	0	0	2
OG0010179	2	0	0	0	0	0	2
OG0010180	2	0	0	0	0	0	2
OG0010181	2	0	0	0	0	0	2
OG0010182	1	0	0	1	0	0	2
OG0010183	1	1	0	0	0	0	2
OG0010184	1	0	1	0	0	0	2
OG0010185	2	0	0	0	0	0	2
OG0010186	2	0	0	0	0	0	2
OG0010187	1	0	1	0	0	0	2
OG0010188	1	0	1	0	0	0	2
OG0010189	2	0	0	0	0	0	2
OG0010190	1	0	1	0	0	0	2
OG0010191	2	0	0	0	0	0	2
OG0010192	2	0	0	0	0	0	2
OG0010193	1	0	1	0	0	0	2
OG0010194	2	0	0	0	0	0	2
OG0010195	2	0	0	0	0	0	2
OG0010196	2	0	0	0	0	0	2
OG0010197	1	0	0	1	0	0	2
OG0010198	2	0	0	0	0	0	2
OG0010199	2	0	0	0	0	0	2
OG0010200	1	0	0	1	0	0	2
OG0010201	2	0	0	0	0	0	2
OG0010202	2	0	0	0	0	0	2
OG0010203	2	0	0	0	0	0	2
OG0010204	2	0	0	0	0	0	2
OG0010205	2	0	0	0	0	0	2
OG0010206	2	0	0	0	0	0	2
OG0010207	1	1	0	0	0	0	2
OG0010208	2	0	0	0	0	0	2
OG0010209	2	0	0	0	0	0	2
OG0010210	2	0	0	0	0	0	2
OG0010211	1	0	1	0	0	0	2
OG0010212	2	0	0	0	0	0	2
OG0010213	1	0	1	0	0	0	2
OG0010214	2	0	0	0	0	0	2
OG0010215	2	0	0	0	0	0	2
OG0010216	1	0	0	0	1	0	2
OG0010217	2	0	0	0	0	0	2
OG0010218	2	0	0	0	0	0	2
OG0010219	2	0	0	0	0	0	2
OG0010220	1	0	1	0	0	0	2
OG0010221	2	0	0	0	0	0	2
OG0010222	1	0	1	0	0	0	2
OG0010223	2	0	0	0	0	0	2
OG0010224	2	0	0	0	0	0	2
OG0010225	2	0	0	0	0	0	2
OG0010226	2	0	0	0	0	0	2
OG0010227	1	1	0	0	0	0	2
OG0010228	2	0	0	0	0	0	2
OG0010229	2	0	0	0	0	0	2
OG0010230	2	0	0	0	0	0	2
OG0010231	1	0	0	0	1	0	2
OG0010232	1	0	1	0	0	0	2
OG0010233	2	0	0	0	0	0	2
OG0010234	1	0	0	0	1	0	2
OG0010235	1	0	1	0	0	0	2
OG0010236	2	0	0	0	0	0	2
OG0010237	1	0	1	0	0	0	2
OG0010238	1	0	1	0	0	0	2
OG0010239	2	0	0	0	0	0	2
OG0010240	2	0	0	0	0	0	2
OG0010241	2	0	0	0	0	0	2
OG0010242	1	1	0	0	0	0	2
OG0010243	1	0	1	0	0	0	2
OG0010244	1	0	1	0	0	0	2
OG0010245	1	0	1	0	0	0	2
OG0010246	1	0	1	0	0	0	2
OG0010247	2	0	0	0	0	0	2
OG0010248	2	0	0	0	0	0	2
OG0010249	2	0	0	0	0	0	2
OG0010250	1	0	1	0	0	0	2
OG0010251	1	1	0	0	0	0	2
OG0010252	1	1	0	0	0	0	2
OG0010253	2	0	0	0	0	0	2
OG0010254	1	0	0	0	1	0	2
OG0010255	2	0	0	0	0	0	2
OG0010256	1	0	1	0	0	0	2
OG0010257	1	0	1	0	0	0	2
OG0010258	1	0	1	0	0	0	2
OG0010259	1	0	1	0	0	0	2
OG0010260	1	1	0	0	0	0	2
OG0010261	1	0	1	0	0	0	2
OG0010262	1	0	0	0	1	0	2
OG0010263	1	1	0	0	0	0	2
OG0010264	1	0	1	0	0	0	2
OG0010265	2	0	0	0	0	0	2
OG0010266	1	0	1	0	0	0	2
OG0010267	1	0	1	0	0	0	2
OG0010268	2	0	0	0	0	0	2
OG0010269	1	0	1	0	0	0	2
OG0010270	2	0	0	0	0	0	2
OG0010271	2	0	0	0	0	0	2
OG0010272	1	0	0	1	0	0	2
OG0010273	1	0	0	1	0	0	2
OG0010274	1	1	0	0	0	0	2
OG0010275	2	0	0	0	0	0	2
OG0010276	1	0	0	1	0	0	2
OG0010277	2	0	0	0	0	0	2
OG0010278	1	0	1	0	0	0	2
OG0010279	1	0	0	0	1	0	2
OG0010280	1	0	0	1	0	0	2
OG0010281	1	0	0	0	0	1	2
OG0010282	1	0	1	0	0	0	2
OG0010283	1	0	1	0	0	0	2
OG0010284	1	0	1	0	0	0	2
OG0010285	1	0	1	0	0	0	2
OG0010286	1	0	1	0	0	0	2
OG0010287	1	0	0	1	0	0	2
OG0010288	1	0	0	1	0	0	2
OG0010289	1	0	1	0	0	0	2
OG0010290	2	0	0	0	0	0	2
OG0010291	1	0	1	0	0	0	2
OG0010292	1	0	1	0	0	0	2
OG0010293	2	0	0	0	0	0	2
OG0010294	1	1	0	0	0	0	2
OG0010295	2	0	0	0	0	0	2
OG0010296	2	0	0	0	0	0	2
OG0010297	2	0	0	0	0	0	2
OG0010298	1	0	1	0	0	0	2
OG0010299	1	0	1	0	0	0	2
OG0010300	1	0	1	0	0	0	2
OG0010301	1	0	1	0	0	0	2
OG0010302	1	0	0	1	0	0	2
OG0010303	1	0	1	0	0	0	2
OG0010304	1	0	0	1	0	0	2
OG0010305	2	0	0	0	0	0	2
OG0010306	1	0	1	0	0	0	2
OG0010307	2	0	0	0	0	0	2
OG0010308	1	0	0	1	0	0	2
OG0010309	1	1	0	0	0	0	2
OG0010310	2	0	0	0	0	0	2
OG0010311	1	1	0	0	0	0	2
OG0010312	1	0	1	0	0	0	2
OG0010313	1	1	0	0	0	0	2
OG0010314	2	0	0	0	0	0	2
OG0010315	1	0	0	1	0	0	2
OG0010316	1	0	1	0	0	0	2
OG0010317	2	0	0	0	0	0	2
OG0010318	1	0	1	0	0	0	2
OG0010319	1	0	0	1	0	0	2
OG0010320	1	0	1	0	0	0	2
OG0010321	1	0	1	0	0	0	2
OG0010322	1	0	0	0	1	0	2
OG0010323	1	0	0	1	0	0	2
OG0010324	1	0	1	0	0	0	2
OG0010325	1	0	0	1	0	0	2
OG0010326	1	0	1	0	0	0	2
OG0010327	2	0	0	0	0	0	2
OG0010328	2	0	0	0	0	0	2
OG0010329	2	0	0	0	0	0	2
OG0010330	2	0	0	0	0	0	2
OG0010331	1	0	1	0	0	0	2
OG0010332	1	1	0	0	0	0	2
OG0010333	1	0	1	0	0	0	2
OG0010334	2	0	0	0	0	0	2
OG0010335	1	0	1	0	0	0	2
OG0010336	1	0	0	1	0	0	2
OG0010337	2	0	0	0	0	0	2
OG0010338	1	0	1	0	0	0	2
OG0010339	1	0	1	0	0	0	2
OG0010340	1	0	1	0	0	0	2
OG0010341	2	0	0	0	0	0	2
OG0010342	1	0	1	0	0	0	2
OG0010343	1	1	0	0	0	0	2
OG0010344	1	0	0	0	1	0	2
OG0010345	1	0	1	0	0	0	2
OG0010346	1	0	1	0	0	0	2
OG0010347	1	0	0	1	0	0	2
OG0010348	1	0	0	1	0	0	2
OG0010349	1	0	0	1	0	0	2
OG0010350	1	0	1	0	0	0	2
OG0010351	1	0	0	0	0	1	2
OG0010352	1	0	1	0	0	0	2
OG0010353	0	1	1	0	0	0	2
OG0010354	0	1	0	0	0	1	2
OG0010355	0	2	0	0	0	0	2
OG0010356	0	2	0	0	0	0	2
OG0010357	0	2	0	0	0	0	2
OG0010358	0	2	0	0	0	0	2
OG0010359	0	1	0	1	0	0	2
OG0010360	0	1	1	0	0	0	2
OG0010361	0	2	0	0	0	0	2
OG0010362	0	1	0	1	0	0	2
OG0010363	0	2	0	0	0	0	2
OG0010364	0	1	1	0	0	0	2
OG0010365	0	2	0	0	0	0	2
OG0010366	0	1	1	0	0	0	2
OG0010367	0	2	0	0	0	0	2
OG0010368	0	2	0	0	0	0	2
OG0010369	0	1	1	0	0	0	2
OG0010370	0	1	1	0	0	0	2
OG0010371	0	2	0	0	0	0	2
OG0010372	0	2	0	0	0	0	2
OG0010373	0	1	1	0	0	0	2
OG0010374	0	2	0	0	0	0	2
OG0010375	0	2	0	0	0	0	2
OG0010376	0	1	1	0	0	0	2
OG0010377	0	1	1	0	0	0	2
OG0010378	0	1	1	0	0	0	2
OG0010379	0	1	1	0	0	0	2
OG0010380	0	2	0	0	0	0	2
OG0010381	0	1	0	1	0	0	2
OG0010382	0	1	0	1	0	0	2
OG0010383	0	2	0	0	0	0	2
OG0010384	0	1	1	0	0	0	2
OG0010385	0	1	1	0	0	0	2
OG0010386	0	1	1	0	0	0	2
OG0010387	0	1	1	0	0	0	2
OG0010388	0	1	0	1	0	0	2
OG0010389	0	2	0	0	0	0	2
OG0010390	0	1	0	0	1	0	2
OG0010391	0	1	0	0	1	0	2
OG0010392	0	1	0	1	0	0	2
OG0010393	0	1	1	0	0	0	2
OG0010394	0	2	0	0	0	0	2
OG0010395	0	1	0	1	0	0	2
OG0010396	0	1	1	0	0	0	2
OG0010397	0	2	0	0	0	0	2
OG0010398	0	2	0	0	0	0	2
OG0010399	0	1	0	0	0	1	2
OG0010400	0	2	0	0	0	0	2
OG0010401	0	2	0	0	0	0	2
OG0010402	0	1	1	0	0	0	2
OG0010403	0	1	0	1	0	0	2
OG0010404	0	1	1	0	0	0	2
OG0010405	0	1	1	0	0	0	2
OG0010406	0	1	0	0	0	1	2
OG0010407	0	1	1	0	0	0	2
OG0010408	0	1	1	0	0	0	2
OG0010409	0	2	0	0	0	0	2
OG0010410	0	1	0	1	0	0	2
OG0010411	0	2	0	0	0	0	2
OG0010412	0	2	0	0	0	0	2
OG0010413	0	2	0	0	0	0	2
OG0010414	0	1	0	1	0	0	2
OG0010415	0	2	0	0	0	0	2
OG0010416	0	1	0	0	1	0	2
OG0010417	0	1	1	0	0	0	2
OG0010418	0	1	0	0	1	0	2
OG0010419	0	2	0	0	0	0	2
OG0010420	0	1	1	0	0	0	2
OG0010421	0	2	0	0	0	0	2
OG0010422	0	1	0	0	1	0	2
OG0010423	0	2	0	0	0	0	2
OG0010424	0	2	0	0	0	0	2
OG0010425	0	1	1	0	0	0	2
OG0010426	0	1	1	0	0	0	2
OG0010427	0	1	0	1	0	0	2
OG0010428	0	1	0	1	0	0	2
OG0010429	0	1	1	0	0	0	2
OG0010430	0	1	1	0	0	0	2
OG0010431	0	2	0	0	0	0	2
OG0010432	0	2	0	0	0	0	2
OG0010433	0	2	0	0	0	0	2
OG0010434	0	1	1	0	0	0	2
OG0010435	0	1	1	0	0	0	2
OG0010436	0	2	0	0	0	0	2
OG0010437	0	1	0	0	1	0	2
OG0010438	0	1	0	0	1	0	2
OG0010439	0	2	0	0	0	0	2
OG0010440	0	1	1	0	0	0	2
OG0010441	0	2	0	0	0	0	2
OG0010442	0	2	0	0	0	0	2
OG0010443	0	2	0	0	0	0	2
OG0010444	0	1	1	0	0	0	2
OG0010445	0	2	0	0	0	0	2
OG0010446	0	2	0	0	0	0	2
OG0010447	0	1	0	1	0	0	2
OG0010448	0	1	0	1	0	0	2
OG0010449	0	2	0	0	0	0	2
OG0010450	0	2	0	0	0	0	2
OG0010451	0	1	0	1	0	0	2
OG0010452	0	0	2	0	0	0	2
OG0010453	0	0	2	0	0	0	2
OG0010454	0	0	2	0	0	0	2
OG0010455	0	0	1	0	0	1	2
OG0010456	0	0	1	0	1	0	2
OG0010457	0	0	2	0	0	0	2
OG0010458	0	0	1	1	0	0	2
OG0010459	0	0	1	0	0	1	2
OG0010460	0	0	2	0	0	0	2
OG0010461	0	0	1	1	0	0	2
OG0010462	0	0	2	0	0	0	2
OG0010463	0	0	1	0	1	0	2
OG0010464	0	0	2	0	0	0	2
OG0010465	0	0	1	1	0	0	2
OG0010466	0	0	2	0	0	0	2
OG0010467	0	0	1	1	0	0	2
OG0010468	0	0	1	1	0	0	2
OG0010469	0	0	1	0	1	0	2
OG0010470	0	0	1	1	0	0	2
OG0010471	0	0	1	0	0	1	2
OG0010472	0	0	1	1	0	0	2
OG0010473	0	0	1	0	0	1	2
OG0010474	0	0	2	0	0	0	2
OG0010475	0	0	1	0	1	0	2
OG0010476	0	0	1	0	1	0	2
OG0010477	0	0	1	0	1	0	2
OG0010478	0	0	1	0	1	0	2
OG0010479	0	0	2	0	0	0	2
OG0010480	0	0	2	0	0	0	2
OG0010481	0	0	1	1	0	0	2
OG0010482	0	0	1	0	0	1	2
OG0010483	0	0	2	0	0	0	2
OG0010484	0	0	1	0	0	1	2
OG0010485	0	0	2	0	0	0	2
OG0010486	0	0	2	0	0	0	2
OG0010487	0	0	2	0	0	0	2
OG0010488	0	0	2	0	0	0	2
OG0010489	0	0	2	0	0	0	2
OG0010490	0	0	2	0	0	0	2
OG0010491	0	0	1	0	0	1	2
OG0010492	0	0	1	0	1	0	2
OG0010493	0	0	1	0	1	0	2
OG0010494	0	0	1	0	1	0	2
OG0010495	0	0	1	0	0	1	2
OG0010496	0	0	1	0	1	0	2
OG0010497	0	0	2	0	0	0	2
OG0010498	0	0	1	0	0	1	2
OG0010499	0	0	2	0	0	0	2
OG0010500	0	0	1	1	0	0	2
OG0010501	0	0	2	0	0	0	2
OG0010502	0	0	2	0	0	0	2
OG0010503	0	0	1	1	0	0	2
OG0010504	0	0	1	0	0	1	2
OG0010505	0	0	1	1	0	0	2
OG0010506	0	0	1	1	0	0	2
OG0010507	0	0	1	1	0	0	2
OG0010508	0	0	1	0	0	1	2
OG0010509	0	0	1	0	0	1	2
OG0010510	0	0	1	0	1	0	2
OG0010511	0	0	1	1	0	0	2
OG0010512	0	0	2	0	0	0	2
OG0010513	0	0	2	0	0	0	2
OG0010514	0	0	1	0	0	1	2
OG0010515	0	0	1	0	1	0	2
OG0010516	0	0	1	0	1	0	2
OG0010517	0	0	2	0	0	0	2
OG0010518	0	0	1	0	1	0	2
OG0010519	0	0	1	1	0	0	2
OG0010520	0	0	1	0	1	0	2
OG0010521	0	0	1	0	1	0	2
OG0010522	0	0	1	1	0	0	2
OG0010523	0	0	1	0	1	0	2
OG0010524	0	0	1	1	0	0	2
OG0010525	0	0	1	0	1	0	2
OG0010526	0	0	1	0	0	1	2
OG0010527	0	0	1	0	1	0	2
OG0010528	0	0	1	0	0	1	2
OG0010529	0	0	1	1	0	0	2
OG0010530	0	0	1	0	1	0	2
OG0010531	0	0	2	0	0	0	2
OG0010532	0	0	1	0	1	0	2
OG0010533	0	0	1	1	0	0	2
OG0010534	0	0	1	0	1	0	2
OG0010535	0	0	1	0	0	1	2
OG0010536	0	0	1	1	0	0	2
OG0010537	0	0	1	1	0	0	2
OG0010538	0	0	1	1	0	0	2
OG0010539	0	0	1	1	0	0	2
OG0010540	0	0	2	0	0	0	2
OG0010541	0	0	2	0	0	0	2
OG0010542	0	0	2	0	0	0	2
OG0010543	0	0	2	0	0	0	2
OG0010544	0	0	2	0	0	0	2
OG0010545	0	0	1	1	0	0	2
OG0010546	0	0	1	1	0	0	2
OG0010547	0	0	1	0	1	0	2
OG0010548	0	0	1	1	0	0	2
OG0010549	0	0	2	0	0	0	2
OG0010550	0	0	2	0	0	0	2
OG0010551	0	0	2	0	0	0	2
OG0010552	0	0	1	0	1	0	2
OG0010553	0	0	1	0	0	1	2
OG0010554	0	0	1	0	0	1	2
OG0010555	0	0	2	0	0	0	2
OG0010556	0	0	2	0	0	0	2
OG0010557	0	0	1	0	1	0	2
OG0010558	0	0	2	0	0	0	2
OG0010559	0	0	1	1	0	0	2
OG0010560	0	0	2	0	0	0	2
OG0010561	0	0	1	0	0	1	2
OG0010562	0	0	1	0	0	1	2
OG0010563	0	0	1	1	0	0	2
OG0010564	0	0	1	1	0	0	2
OG0010565	0	0	1	0	1	0	2
OG0010566	0	0	1	0	1	0	2
OG0010567	0	0	1	1	0	0	2
OG0010568	0	0	1	0	1	0	2
OG0010569	0	0	1	1	0	0	2
OG0010570	0	0	2	0	0	0	2
OG0010571	0	0	1	0	1	0	2
OG0010572	0	0	1	1	0	0	2
OG0010573	0	0	1	0	1	0	2
OG0010574	0	0	1	0	1	0	2
OG0010575	0	0	1	0	1	0	2
OG0010576	0	0	1	1	0	0	2
OG0010577	0	0	1	0	0	1	2
OG0010578	0	0	1	0	1	0	2
OG0010579	0	0	1	0	1	0	2
OG0010580	0	0	2	0	0	0	2
OG0010581	0	0	1	0	1	0	2
OG0010582	0	0	1	0	1	0	2
OG0010583	0	0	2	0	0	0	2
OG0010584	0	0	2	0	0	0	2
OG0010585	0	0	2	0	0	0	2
OG0010586	0	0	1	0	0	1	2
OG0010587	0	0	1	0	1	0	2
OG0010588	0	0	1	0	0	1	2
OG0010589	0	0	1	0	0	1	2
OG0010590	0	0	1	0	0	1	2
OG0010591	0	0	1	1	0	0	2
OG0010592	0	0	2	0	0	0	2
OG0010593	0	0	2	0	0	0	2
OG0010594	0	0	2	0	0	0	2
OG0010595	0	0	2	0	0	0	2
OG0010596	0	0	1	0	1	0	2
OG0010597	0	0	1	1	0	0	2
OG0010598	0	0	1	1	0	0	2
OG0010599	0	0	2	0	0	0	2
OG0010600	0	0	1	1	0	0	2
OG0010601	0	0	1	1	0	0	2
OG0010602	0	0	1	1	0	0	2
OG0010603	0	0	1	0	1	0	2
OG0010604	0	0	1	1	0	0	2
OG0010605	0	0	1	1	0	0	2
OG0010606	0	0	1	0	0	1	2
OG0010607	0	0	1	0	0	1	2
OG0010608	0	0	1	0	1	0	2
OG0010609	0	0	1	1	0	0	2
OG0010610	0	0	2	0	0	0	2
OG0010611	0	0	1	0	0	1	2
OG0010612	0	0	1	0	1	0	2
OG0010613	0	0	1	1	0	0	2
OG0010614	0	0	1	0	0	1	2
OG0010615	0	0	1	0	1	0	2
OG0010616	0	0	1	0	1	0	2
OG0010617	0	0	2	0	0	0	2
OG0010618	0	0	1	0	1	0	2
OG0010619	0	0	2	0	0	0	2
OG0010620	0	0	1	0	0	1	2
OG0010621	0	0	1	0	0	1	2
OG0010622	0	0	1	0	1	0	2
OG0010623	0	0	1	0	0	1	2
OG0010624	0	0	1	1	0	0	2
OG0010625	0	0	1	0	1	0	2
OG0010626	0	0	1	1	0	0	2
OG0010627	0	0	1	0	0	1	2
OG0010628	0	0	1	1	0	0	2
OG0010629	0	0	1	1	0	0	2
OG0010630	0	0	1	1	0	0	2
OG0010631	0	0	2	0	0	0	2
OG0010632	0	0	1	1	0	0	2
OG0010633	0	0	1	1	0	0	2
OG0010634	0	0	1	0	1	0	2
OG0010635	0	0	1	1	0	0	2
OG0010636	0	0	1	0	1	0	2
OG0010637	0	0	1	0	0	1	2
OG0010638	0	0	1	0	0	1	2
OG0010639	0	0	1	0	0	1	2
OG0010640	0	0	1	0	1	0	2
OG0010641	0	0	1	0	0	1	2
OG0010642	0	0	1	1	0	0	2
OG0010643	0	0	1	1	0	0	2
OG0010644	0	0	1	1	0	0	2
OG0010645	0	0	1	1	0	0	2
OG0010646	0	0	1	0	0	1	2
OG0010647	0	0	1	0	1	0	2
OG0010648	0	0	2	0	0	0	2
OG0010649	0	0	1	0	0	1	2
OG0010650	0	0	2	0	0	0	2
OG0010651	0	0	1	1	0	0	2
OG0010652	0	0	1	0	1	0	2
OG0010653	0	0	1	0	1	0	2
OG0010654	0	0	1	0	1	0	2
OG0010655	0	0	1	0	0	1	2
OG0010656	0	0	1	0	0	1	2
OG0010657	0	0	1	1	0	0	2
OG0010658	0	0	1	1	0	0	2
OG0010659	0	0	2	0	0	0	2
OG0010660	0	0	1	0	0	1	2
OG0010661	0	0	1	0	0	1	2
OG0010662	0	0	1	0	0	1	2
OG0010663	0	0	1	1	0	0	2
OG0010664	0	0	1	0	1	0	2
OG0010665	0	0	1	0	1	0	2
OG0010666	0	0	1	0	1	0	2
OG0010667	0	0	1	1	0	0	2
OG0010668	0	0	1	1	0	0	2
OG0010669	0	0	1	0	0	1	2
OG0010670	0	0	1	1	0	0	2
OG0010671	0	0	1	0	1	0	2
OG0010672	0	0	2	0	0	0	2
OG0010673	0	0	1	0	1	0	2
OG0010674	0	0	1	0	0	1	2
OG0010675	0	0	1	0	1	0	2
OG0010676	0	0	1	1	0	0	2
OG0010677	0	0	1	0	1	0	2
OG0010678	0	0	1	0	1	0	2
OG0010679	0	0	1	0	0	1	2
OG0010680	0	0	1	0	1	0	2
OG0010681	0	0	1	0	1	0	2
OG0010682	0	0	1	0	1	0	2
OG0010683	0	0	1	0	1	0	2
OG0010684	0	0	1	0	1	0	2
OG0010685	0	0	1	0	0	1	2
OG0010686	0	0	1	0	1	0	2
OG0010687	0	0	1	0	1	0	2
OG0010688	0	0	1	0	1	0	2
OG0010689	0	0	1	1	0	0	2
OG0010690	0	0	2	0	0	0	2
OG0010691	0	0	1	0	0	1	2
OG0010692	0	0	1	0	1	0	2
OG0010693	0	0	1	0	0	1	2
OG0010694	0	0	1	0	0	1	2
OG0010695	0	0	1	1	0	0	2
OG0010696	0	0	1	0	1	0	2
OG0010697	0	0	1	0	1	0	2
OG0010698	0	0	1	0	0	1	2
OG0010699	0	0	1	0	0	1	2
OG0010700	0	0	1	1	0	0	2
OG0010701	0	0	1	1	0	0	2
OG0010702	0	0	2	0	0	0	2
OG0010703	0	0	1	1	0	0	2
OG0010704	0	0	1	0	1	0	2
OG0010705	0	0	1	0	1	0	2
OG0010706	0	0	1	0	0	1	2
OG0010707	0	0	1	0	1	0	2
OG0010708	0	0	1	0	0	1	2
OG0010709	0	0	1	0	0	1	2
OG0010710	0	0	1	0	0	1	2
OG0010711	0	0	2	0	0	0	2
OG0010712	0	0	1	0	0	1	2
OG0010713	0	0	1	0	1	0	2
OG0010714	0	0	1	0	0	1	2
OG0010715	0	0	1	0	1	0	2
OG0010716	0	0	1	0	0	1	2
OG0010717	0	0	1	0	1	0	2
OG0010718	0	0	1	0	0	1	2
OG0010719	0	0	1	0	0	1	2
OG0010720	0	0	1	1	0	0	2
OG0010721	0	0	1	0	0	1	2
OG0010722	0	0	1	0	1	0	2
OG0010723	0	0	1	0	0	1	2
OG0010724	0	0	1	0	1	0	2
OG0010725	0	0	1	1	0	0	2
OG0010726	0	0	1	0	1	0	2
OG0010727	0	0	1	0	0	1	2
OG0010728	0	0	0	2	0	0	2
OG0010729	0	0	0	2	0	0	2
OG0010730	0	0	0	2	0	0	2
OG0010731	0	0	0	2	0	0	2
OG0010732	0	0	0	2	0	0	2
OG0010733	0	0	0	1	0	1	2
OG0010734	0	0	0	2	0	0	2
OG0010735	0	0	0	2	0	0	2
OG0010736	0	0	0	1	0	1	2
OG0010737	0	0	0	2	0	0	2
OG0010738	0	0	0	1	1	0	2
OG0010739	0	0	0	2	0	0	2
OG0010740	0	0	0	2	0	0	2
OG0010741	0	0	0	1	1	0	2
OG0010742	0	0	0	2	0	0	2
OG0010743	0	0	0	1	0	1	2
OG0010744	0	0	0	2	0	0	2
OG0010745	0	0	0	2	0	0	2
OG0010746	0	0	0	2	0	0	2
OG0010747	0	0	0	1	0	1	2
OG0010748	0	0	0	2	0	0	2
OG0010749	0	0	0	2	0	0	2
OG0010750	0	0	0	2	0	0	2
OG0010751	0	0	0	1	0	1	2
OG0010752	0	0	0	2	0	0	2
OG0010753	0	0	0	1	0	1	2
OG0010754	0	0	0	2	0	0	2
OG0010755	0	0	0	2	0	0	2
OG0010756	0	0	0	1	1	0	2
OG0010757	0	0	0	2	0	0	2
OG0010758	0	0	0	2	0	0	2
OG0010759	0	0	0	2	0	0	2
OG0010760	0	0	0	2	0	0	2
OG0010761	0	0	0	2	0	0	2
OG0010762	0	0	0	2	0	0	2
OG0010763	0	0	0	2	0	0	2
OG0010764	0	0	0	1	1	0	2
OG0010765	0	0	0	2	0	0	2
OG0010766	0	0	0	2	0	0	2
OG0010767	0	0	0	2	0	0	2
OG0010768	0	0	0	2	0	0	2
OG0010769	0	0	0	1	0	1	2
OG0010770	0	0	0	2	0	0	2
OG0010771	0	0	0	1	0	1	2
OG0010772	0	0	0	2	0	0	2
OG0010773	0	0	0	1	0	1	2
OG0010774	0	0	0	2	0	0	2
OG0010775	0	0	0	2	0	0	2
OG0010776	0	0	0	1	1	0	2
OG0010777	0	0	0	2	0	0	2
OG0010778	0	0	0	2	0	0	2
OG0010779	0	0	0	1	0	1	2
OG0010780	0	0	0	2	0	0	2
OG0010781	0	0	0	1	1	0	2
OG0010782	0	0	0	1	1	0	2
OG0010783	0	0	0	2	0	0	2
OG0010784	0	0	0	2	0	0	2
OG0010785	0	0	0	2	0	0	2
OG0010786	0	0	0	2	0	0	2
OG0010787	0	0	0	0	2	0	2
OG0010788	0	0	0	0	1	1	2
OG0010789	0	0	0	0	1	1	2
OG0010790	0	0	0	0	1	1	2
OG0010791	0	0	0	0	1	1	2
OG0010792	0	0	0	0	1	1	2
OG0010793	0	0	0	0	1	1	2
OG0010794	0	0	0	0	1	1	2
OG0010795	0	0	0	0	1	1	2
OG0010796	0	0	0	0	2	0	2
OG0010797	0	0	0	0	1	1	2
OG0010798	0	0	0	0	1	1	2
OG0010799	0	0	0	0	1	1	2
OG0010800	0	0	0	0	1	1	2
OG0010801	0	0	0	0	1	1	2
OG0010802	0	0	0	0	1	1	2
OG0010803	0	0	0	0	1	1	2
OG0010804	0	0	0	0	1	1	2
OG0010805	0	0	0	0	1	1	2
OG0010806	0	0	0	0	1	1	2
OG0010807	0	0	0	0	1	1	2
OG0010808	0	0	0	0	1	1	2
OG0010809	0	0	0	0	1	1	2
OG0010810	0	0	0	0	1	1	2
OG0010811	0	0	0	0	1	1	2
OG0010812	0	0	0	0	2	0	2
OG0010813	0	0	0	0	1	1	2
OG0010814	0	0	0	0	1	1	2
OG0010815	0	0	0	0	1	1	2
OG0010816	0	0	0	0	1	1	2
OG0010817	0	0	0	0	1	1	2
OG0010818	0	0	0	0	1	1	2
OG0010819	0	0	0	0	1	1	2
OG0010820	0	0	0	0	1	1	2
OG0010821	0	0	0	0	1	1	2
OG0010822	0	0	0	0	1	1	2
OG0010823	0	0	0	0	1	1	2
OG0010824	0	0	0	0	1	1	2
OG0010825	0	0	0	0	1	1	2
OG0010826	0	0	0	0	1	1	2
OG0010827	0	0	0	0	1	1	2
OG0010828	0	0	0	0	2	0	2
OG0010829	0	0	0	0	1	1	2
OG0010830	0	0	0	0	1	1	2
OG0010831	0	0	0	0	1	1	2
OG0010832	0	0	0	0	1	1	2
OG0010833	0	0	0	0	2	0	2
OG0010834	0	0	0	0	1	1	2
OG0010835	0	0	0	0	1	1	2
OG0010836	0	0	0	0	1	1	2
OG0010837	0	0	0	0	1	1	2
OG0010838	0	0	0	0	1	1	2
OG0010839	0	0	0	0	1	1	2
OG0010840	0	0	0	0	1	1	2
OG0010841	0	0	0	0	1	1	2
OG0010842	0	0	0	0	1	1	2
OG0010843	0	0	0	0	1	1	2
OG0010844	0	0	0	0	1	1	2
OG0010845	0	0	0	0	1	1	2
OG0010846	0	0	0	0	1	1	2
OG0010847	0	0	0	0	2	0	2
OG0010848	0	0	0	0	1	1	2
OG0010849	0	0	0	0	2	0	2
OG0010850	0	0	0	0	1	1	2
OG0010851	0	0	0	0	1	1	2
OG0010852	0	0	0	0	1	1	2
OG0010853	0	0	0	0	1	1	2
OG0010854	0	0	0	0	1	1	2
OG0010855	0	0	0	0	1	1	2
OG0010856	0	0	0	0	1	1	2
OG0010857	0	0	0	0	2	0	2
OG0010858	0	0	0	0	2	0	2
OG0010859	0	0	0	0	2	0	2
OG0010860	0	0	0	0	2	0	2
OG0010861	0	0	0	0	1	1	2
OG0010862	0	0	0	0	2	0	2
OG0010863	0	0	0	0	2	0	2
OG0010864	0	0	0	0	1	1	2
OG0010865	0	0	0	0	2	0	2
OG0010866	0	0	0	0	1	1	2
OG0010867	0	0	0	0	1	1	2
OG0010868	0	0	0	0	1	1	2
OG0010869	0	0	0	0	1	1	2
OG0010870	0	0	0	0	1	1	2
OG0010871	0	0	0	0	1	1	2
OG0010872	0	0	0	0	1	1	2
OG0010873	0	0	0	0	0	2	2
OG0010874	0	0	0	0	0	2	2
OG0010875	0	0	0	0	0	2	2
OG0010876	0	0	0	0	0	2	2
OG0010877	0	0	0	0	0	2	2
OG0010878	0	0	0	0	0	2	2
OG0010879	0	0	0	0	0	2	2
OG0010880	0	0	0	0	0	2	2
OG0010881	0	0	0	0	0	2	2
OG0010882	0	0	0	0	0	2	2
OG0010883	0	0	0	0	0	2	2
OG0010884	0	0	0	0	0	2	2
OG0010885	0	0	0	0	0	2	2
OG0010886	0	0	0	0	0	2	2
OG0010887	0	0	0	0	0	2	2
OG0010888	0	0	0	0	0	2	2
