Orthogroup	Apis_mellifera-longest-isoforms	Liostenogaster_flavolineata-longest-isoforms	Polistes_canadensis-longest-isoforms	Polistes_dominula-longest-isoforms	Total
OG0000000	5	29	6	8	48
OG0000001	12	12	10	10	44
OG0000002	0	42	0	1	43
OG0000003	18	1	4	15	38
OG0000004	1	30	0	6	37
OG0000005	0	3	13	21	37
OG0000006	0	17	8	11	36
OG0000007	7	13	8	6	34
OG0000008	25	1	3	3	32
OG0000009	8	11	6	7	32
OG0000010	25	1	2	3	31
OG0000011	0	31	0	0	31
OG0000012	5	12	5	8	30
OG0000013	18	1	2	7	28
OG0000014	11	1	14	2	28
OG0000015	0	0	3	25	28
OG0000016	18	1	3	5	27
OG0000017	8	6	7	6	27
OG0000018	9	1	14	3	27
OG0000019	22	1	1	2	26
OG0000020	7	2	3	14	26
OG0000021	19	1	4	2	26
OG0000022	7	6	5	7	25
OG0000023	5	8	6	6	25
OG0000024	0	19	2	4	25
OG0000025	18	1	2	3	24
OG0000026	6	1	15	2	24
OG0000027	18	1	2	2	23
OG0000028	14	1	2	6	23
OG0000029	9	1	4	9	23
OG0000030	1	14	4	4	23
OG0000031	0	19	1	3	23
OG0000032	0	2	13	8	23
OG0000033	8	1	9	4	22
OG0000034	8	1	1	12	22
OG0000035	6	1	2	13	22
OG0000036	8	1	8	4	21
OG0000037	12	3	3	2	20
OG0000038	4	8	4	4	20
OG0000039	4	1	6	9	20
OG0000040	6	1	4	9	20
OG0000041	7	1	11	1	20
OG0000042	8	2	5	5	20
OG0000043	4	7	4	4	19
OG0000044	6	5	5	3	19
OG0000045	0	19	0	0	19
OG0000046	4	6	5	3	18
OG0000047	4	1	3	10	18
OG0000048	1	1	3	13	18
OG0000049	9	1	2	6	18
OG0000050	8	5	2	3	18
OG0000051	18	0	0	0	18
OG0000052	14	1	2	1	18
OG0000053	18	0	0	0	18
OG0000054	0	15	1	2	18
OG0000055	0	1	2	15	18
OG0000056	9	1	3	4	17
OG0000057	12	1	2	2	17
OG0000058	6	1	8	2	17
OG0000059	1	10	2	4	17
OG0000060	9	1	1	6	17
OG0000061	12	1	3	1	17
OG0000062	7	1	1	8	17
OG0000063	5	1	4	7	17
OG0000064	8	1	6	2	17
OG0000065	8	1	5	3	17
OG0000066	0	1	16	0	17
OG0000067	7	0	2	7	16
OG0000068	11	1	2	2	16
OG0000069	7	1	2	6	16
OG0000070	5	1	4	6	16
OG0000071	3	1	9	3	16
OG0000072	0	2	3	11	16
OG0000073	8	1	1	5	15
OG0000074	7	1	4	3	15
OG0000075	2	4	4	5	15
OG0000076	4	3	4	4	15
OG0000077	7	1	5	2	15
OG0000078	6	4	3	2	15
OG0000079	11	1	3	0	15
OG0000080	8	1	3	3	15
OG0000081	1	1	4	9	15
OG0000082	11	1	2	1	15
OG0000083	5	1	6	3	15
OG0000084	9	1	3	2	15
OG0000085	11	0	2	2	15
OG0000086	7	1	5	2	15
OG0000087	12	1	1	1	15
OG0000088	4	4	3	4	15
OG0000089	0	15	0	0	15
OG0000090	0	15	0	0	15
OG0000091	0	1	12	2	15
OG0000092	0	0	0	15	15
OG0000093	1	6	4	3	14
OG0000094	3	5	5	1	14
OG0000095	8	1	3	2	14
OG0000096	6	1	4	3	14
OG0000097	8	1	3	2	14
OG0000098	6	1	2	5	14
OG0000099	8	1	3	2	14
OG0000100	4	1	2	7	14
OG0000101	2	1	10	1	14
OG0000102	4	1	1	8	14
OG0000103	9	1	1	3	14
OG0000104	7	1	4	2	14
OG0000105	7	1	3	3	14
OG0000106	4	1	2	7	14
OG0000107	5	1	6	2	14
OG0000108	4	1	2	7	14
OG0000109	8	1	2	3	14
OG0000110	6	1	2	5	14
OG0000111	0	14	0	0	14
OG0000112	0	0	4	10	14
OG0000113	0	0	0	14	14
OG0000114	5	1	4	3	13
OG0000115	3	3	4	3	13
OG0000116	1	5	3	4	13
OG0000117	8	1	2	2	13
OG0000118	7	1	1	4	13
OG0000119	8	1	2	2	13
OG0000120	6	1	2	4	13
OG0000121	8	1	2	2	13
OG0000122	10	1	1	1	13
OG0000123	9	1	1	2	13
OG0000124	8	1	2	2	13
OG0000125	8	1	2	2	13
OG0000126	4	1	6	2	13
OG0000127	5	1	3	4	13
OG0000128	3	4	4	2	13
OG0000129	6	1	2	4	13
OG0000130	3	1	7	2	13
OG0000131	2	1	2	8	13
OG0000132	12	1	0	0	13
OG0000133	6	1	4	2	13
OG0000134	6	1	1	5	13
OG0000135	7	1	3	2	13
OG0000136	7	1	2	3	13
OG0000137	5	1	5	2	13
OG0000138	4	0	3	6	13
OG0000139	6	1	1	5	13
OG0000140	5	2	4	2	13
OG0000141	5	1	5	2	13
OG0000142	2	1	3	7	13
OG0000143	8	1	1	3	13
OG0000144	4	2	4	3	13
OG0000145	5	1	2	5	13
OG0000146	1	1	1	10	13
OG0000147	7	1	3	2	13
OG0000148	7	1	2	3	13
OG0000149	6	1	2	4	13
OG0000150	8	1	2	2	13
OG0000151	1	4	4	4	13
OG0000152	0	13	0	0	13
OG0000153	0	5	2	6	13
OG0000154	1	4	4	3	12
OG0000155	7	1	2	2	12
OG0000156	3	3	3	3	12
OG0000157	4	1	4	3	12
OG0000158	5	2	0	5	12
OG0000159	1	2	7	2	12
OG0000160	4	4	1	3	12
OG0000161	3	3	3	3	12
OG0000162	3	1	5	3	12
OG0000163	4	1	5	2	12
OG0000164	8	1	2	1	12
OG0000165	6	1	3	2	12
OG0000166	7	1	2	2	12
OG0000167	3	1	5	3	12
OG0000168	1	9	1	1	12
OG0000169	7	1	2	2	12
OG0000170	5	3	3	1	12
OG0000171	4	1	4	3	12
OG0000172	4	1	5	2	12
OG0000173	2	4	2	4	12
OG0000174	4	2	2	4	12
OG0000175	4	1	2	5	12
OG0000176	5	1	5	1	12
OG0000177	8	1	2	1	12
OG0000178	9	1	1	1	12
OG0000179	3	5	3	1	12
OG0000180	4	2	4	2	12
OG0000181	4	1	2	5	12
OG0000182	7	2	2	1	12
OG0000183	2	5	2	3	12
OG0000184	4	1	3	4	12
OG0000185	3	2	6	1	12
OG0000186	4	1	4	3	12
OG0000187	4	1	2	5	12
OG0000188	9	1	1	1	12
OG0000189	9	1	1	1	12
OG0000190	5	1	2	4	12
OG0000191	6	1	3	2	12
OG0000192	5	1	5	1	12
OG0000193	9	1	1	1	12
OG0000194	1	11	0	0	12
OG0000195	12	0	0	0	12
OG0000196	3	1	3	5	12
OG0000197	1	5	1	5	12
OG0000198	3	0	2	7	12
OG0000199	9	1	1	1	12
OG0000200	4	1	1	6	12
OG0000201	5	1	4	2	12
OG0000202	10	1	1	0	12
OG0000203	5	1	4	2	12
OG0000204	2	1	8	1	12
OG0000205	2	1	2	7	12
OG0000206	2	3	4	3	12
OG0000207	3	1	2	6	12
OG0000208	0	12	0	0	12
OG0000209	0	7	3	2	12
OG0000210	0	12	0	0	12
OG0000211	0	1	5	6	12
OG0000212	0	6	3	3	12
OG0000213	0	5	4	3	12
OG0000214	6	2	2	1	11
OG0000215	2	1	3	5	11
OG0000216	4	2	3	2	11
OG0000217	1	6	2	2	11
OG0000218	5	2	3	1	11
OG0000219	7	1	2	1	11
OG0000220	7	1	1	2	11
OG0000221	10	1	0	0	11
OG0000222	3	1	1	6	11
OG0000223	3	1	2	5	11
OG0000224	2	1	3	5	11
OG0000225	4	1	3	3	11
OG0000226	5	2	3	1	11
OG0000227	4	3	2	2	11
OG0000228	6	1	1	3	11
OG0000229	6	1	1	3	11
OG0000230	5	2	2	2	11
OG0000231	5	1	2	3	11
OG0000232	4	2	4	1	11
OG0000233	4	3	2	2	11
OG0000234	5	1	3	2	11
OG0000235	5	1	3	2	11
OG0000236	7	1	2	1	11
OG0000237	5	1	3	2	11
OG0000238	5	1	1	4	11
OG0000239	4	2	3	2	11
OG0000240	9	1	1	0	11
OG0000241	5	1	2	3	11
OG0000242	5	1	1	4	11
OG0000243	6	1	2	2	11
OG0000244	7	1	1	2	11
OG0000245	6	1	2	2	11
OG0000246	4	1	2	4	11
OG0000247	6	1	3	1	11
OG0000248	5	1	3	2	11
OG0000249	7	1	2	1	11
OG0000250	1	1	4	5	11
OG0000251	7	1	2	1	11
OG0000252	4	2	2	3	11
OG0000253	3	1	3	4	11
OG0000254	1	5	2	3	11
OG0000255	5	1	1	4	11
OG0000256	1	1	8	1	11
OG0000257	8	1	0	2	11
OG0000258	4	1	2	4	11
OG0000259	1	2	3	5	11
OG0000260	2	1	2	6	11
OG0000261	5	1	3	2	11
OG0000262	7	1	1	2	11
OG0000263	7	1	1	2	11
OG0000264	4	1	4	2	11
OG0000265	4	1	4	2	11
OG0000266	5	1	2	3	11
OG0000267	1	6	3	1	11
OG0000268	5	1	3	2	11
OG0000269	7	1	1	2	11
OG0000270	6	1	2	2	11
OG0000271	6	1	2	2	11
OG0000272	2	5	1	3	11
OG0000273	1	1	2	7	11
OG0000274	5	1	2	3	11
OG0000275	1	1	8	1	11
OG0000276	1	1	3	6	11
OG0000277	0	2	3	6	11
OG0000278	0	1	8	2	11
OG0000279	0	2	7	2	11
OG0000280	0	1	2	8	11
OG0000281	0	0	1	10	11
OG0000282	2	3	4	1	10
OG0000283	2	4	2	2	10
OG0000284	4	2	1	3	10
OG0000285	5	0	1	4	10
OG0000286	7	1	0	2	10
OG0000287	4	2	1	3	10
OG0000288	5	1	2	2	10
OG0000289	10	0	0	0	10
OG0000290	4	3	2	1	10
OG0000291	2	1	4	3	10
OG0000292	5	1	3	1	10
OG0000293	2	4	2	2	10
OG0000294	3	2	2	3	10
OG0000295	6	1	2	1	10
OG0000296	7	1	1	1	10
OG0000297	2	1	5	2	10
OG0000298	1	4	1	4	10
OG0000299	7	1	1	1	10
OG0000300	5	1	1	3	10
OG0000301	5	1	3	1	10
OG0000302	7	1	1	1	10
OG0000303	5	2	1	2	10
OG0000304	6	1	2	1	10
OG0000305	4	1	2	3	10
OG0000306	6	1	2	1	10
OG0000307	9	0	1	0	10
OG0000308	4	1	2	3	10
OG0000309	4	2	2	2	10
OG0000310	6	1	1	2	10
OG0000311	4	1	3	2	10
OG0000312	2	1	3	4	10
OG0000313	5	1	1	3	10
OG0000314	3	3	2	2	10
OG0000315	3	3	3	1	10
OG0000316	3	4	1	2	10
OG0000317	4	2	3	1	10
OG0000318	3	1	2	4	10
OG0000319	3	1	0	6	10
OG0000320	7	1	1	1	10
OG0000321	3	1	4	2	10
OG0000322	5	1	2	2	10
OG0000323	6	1	1	2	10
OG0000324	5	1	2	2	10
OG0000325	4	1	3	2	10
OG0000326	6	1	2	1	10
OG0000327	4	1	3	2	10
OG0000328	4	1	3	2	10
OG0000329	2	1	4	3	10
OG0000330	1	1	4	4	10
OG0000331	7	1	1	1	10
OG0000332	4	1	3	2	10
OG0000333	7	1	0	2	10
OG0000334	3	1	3	3	10
OG0000335	4	2	3	1	10
OG0000336	2	1	5	2	10
OG0000337	3	2	3	2	10
OG0000338	5	2	1	2	10
OG0000339	9	1	0	0	10
OG0000340	3	1	2	4	10
OG0000341	3	1	4	2	10
OG0000342	4	1	2	3	10
OG0000343	2	1	4	3	10
OG0000344	5	2	1	2	10
OG0000345	3	1	2	4	10
OG0000346	4	1	2	3	10
OG0000347	3	1	3	3	10
OG0000348	2	2	3	3	10
OG0000349	5	1	3	1	10
OG0000350	4	1	1	4	10
OG0000351	1	1	7	1	10
OG0000352	2	3	2	3	10
OG0000353	2	1	1	6	10
OG0000354	2	1	2	5	10
OG0000355	1	1	6	2	10
OG0000356	2	1	4	3	10
OG0000357	2	2	1	5	10
OG0000358	4	1	2	3	10
OG0000359	3	1	2	4	10
OG0000360	2	1	4	3	10
OG0000361	5	1	2	2	10
OG0000362	6	2	1	1	10
OG0000363	7	1	1	1	10
OG0000364	1	1	2	6	10
OG0000365	1	1	6	2	10
OG0000366	1	4	2	3	10
OG0000367	1	4	2	3	10
OG0000368	0	2	3	5	10
OG0000369	0	1	3	6	10
OG0000370	3	1	3	2	9
OG0000371	3	1	4	1	9
OG0000372	5	1	1	2	9
OG0000373	5	1	2	1	9
OG0000374	6	1	1	1	9
OG0000375	1	4	2	2	9
OG0000376	4	1	2	2	9
OG0000377	4	1	2	2	9
OG0000378	5	1	2	1	9
OG0000379	1	6	1	1	9
OG0000380	2	3	1	3	9
OG0000381	3	1	2	3	9
OG0000382	5	1	1	2	9
OG0000383	2	3	2	2	9
OG0000384	1	2	2	4	9
OG0000385	1	1	3	4	9
OG0000386	2	1	2	4	9
OG0000387	3	1	4	1	9
OG0000388	5	1	2	1	9
OG0000389	9	0	0	0	9
OG0000390	5	1	2	1	9
OG0000391	2	4	1	2	9
OG0000392	5	1	1	2	9
OG0000393	5	1	1	2	9
OG0000394	4	1	1	3	9
OG0000395	4	1	3	1	9
OG0000396	5	1	2	1	9
OG0000397	2	4	2	1	9
OG0000398	1	1	2	5	9
OG0000399	1	1	2	5	9
OG0000400	8	0	1	0	9
OG0000401	3	1	2	3	9
OG0000402	3	2	2	2	9
OG0000403	3	1	2	3	9
OG0000404	5	1	1	2	9
OG0000405	2	1	1	5	9
OG0000406	2	2	3	2	9
OG0000407	3	1	3	2	9
OG0000408	2	4	1	2	9
OG0000409	3	2	2	2	9
OG0000410	6	1	1	1	9
OG0000411	6	1	1	1	9
OG0000412	6	1	1	1	9
OG0000413	2	2	1	4	9
OG0000414	2	1	1	5	9
OG0000415	4	1	2	2	9
OG0000416	6	1	1	1	9
OG0000417	3	1	2	3	9
OG0000418	6	1	2	0	9
OG0000419	6	1	1	1	9
OG0000420	5	1	1	2	9
OG0000421	4	1	2	2	9
OG0000422	3	1	3	2	9
OG0000423	1	3	3	2	9
OG0000424	3	2	1	3	9
OG0000425	2	1	2	4	9
OG0000426	4	1	0	4	9
OG0000427	4	1	1	3	9
OG0000428	4	1	1	3	9
OG0000429	6	1	1	1	9
OG0000430	4	1	2	2	9
OG0000431	3	1	2	3	9
OG0000432	2	1	4	2	9
OG0000433	3	1	3	2	9
OG0000434	5	1	2	1	9
OG0000435	4	1	2	2	9
OG0000436	3	1	2	3	9
OG0000437	2	1	1	5	9
OG0000438	4	1	2	2	9
OG0000439	3	1	3	2	9
OG0000440	1	1	2	5	9
OG0000441	2	1	4	2	9
OG0000442	3	1	3	2	9
OG0000443	2	1	3	3	9
OG0000444	2	1	5	1	9
OG0000445	3	1	3	2	9
OG0000446	5	1	1	2	9
OG0000447	1	1	4	3	9
OG0000448	6	1	1	1	9
OG0000449	3	1	4	1	9
OG0000450	1	1	3	4	9
OG0000451	2	1	3	3	9
OG0000452	1	7	0	1	9
OG0000453	4	1	1	3	9
OG0000454	3	1	1	4	9
OG0000455	1	1	3	4	9
OG0000456	3	1	3	2	9
OG0000457	1	1	3	4	9
OG0000458	4	1	2	2	9
OG0000459	2	1	2	4	9
OG0000460	5	0	2	2	9
OG0000461	5	1	2	1	9
OG0000462	3	0	2	4	9
OG0000463	4	1	3	1	9
OG0000464	4	1	2	2	9
OG0000465	5	1	1	2	9
OG0000466	3	1	3	2	9
OG0000467	3	2	3	1	9
OG0000468	1	1	5	2	9
OG0000469	5	1	1	2	9
OG0000470	4	1	3	1	9
OG0000471	2	1	2	4	9
OG0000472	3	1	1	4	9
OG0000473	4	1	2	2	9
OG0000474	3	1	3	2	9
OG0000475	2	1	2	4	9
OG0000476	6	1	1	1	9
OG0000477	7	1	1	0	9
OG0000478	4	1	2	2	9
OG0000479	4	1	2	2	9
OG0000480	2	2	3	2	9
OG0000481	4	1	3	1	9
OG0000482	4	1	1	3	9
OG0000483	4	1	3	1	9
OG0000484	5	0	3	1	9
OG0000485	6	1	1	1	9
OG0000486	4	1	2	2	9
OG0000487	5	1	2	1	9
OG0000488	1	1	5	2	9
OG0000489	5	1	1	2	9
OG0000490	7	1	1	0	9
OG0000491	3	1	2	3	9
OG0000492	1	2	1	5	9
OG0000493	3	1	3	2	9
OG0000494	2	2	2	3	9
OG0000495	6	1	1	1	9
OG0000496	5	2	1	1	9
OG0000497	4	1	2	2	9
OG0000498	2	4	1	2	9
OG0000499	4	1	2	2	9
OG0000500	5	2	1	1	9
OG0000501	1	3	3	2	9
OG0000502	2	2	2	3	9
OG0000503	3	1	1	4	9
OG0000504	2	0	3	4	9
OG0000505	2	2	1	4	9
OG0000506	4	1	2	2	9
OG0000507	5	1	1	2	9
OG0000508	1	2	1	5	9
OG0000509	1	1	5	2	9
OG0000510	2	1	1	5	9
OG0000511	1	1	1	6	9
OG0000512	5	1	1	2	9
OG0000513	2	3	2	2	9
OG0000514	3	1	4	1	9
OG0000515	2	2	2	3	9
OG0000516	4	1	1	3	9
OG0000517	3	1	2	3	9
OG0000518	6	1	1	1	9
OG0000519	2	1	4	2	9
OG0000520	3	1	2	3	9
OG0000521	5	1	1	2	9
OG0000522	1	3	3	2	9
OG0000523	1	2	4	2	9
OG0000524	1	2	3	3	9
OG0000525	0	6	1	2	9
OG0000526	0	9	0	0	9
OG0000527	0	1	0	8	9
OG0000528	0	8	1	0	9
OG0000529	0	8	0	1	9
OG0000530	0	3	2	4	9
OG0000531	0	5	1	3	9
OG0000532	0	1	1	7	9
OG0000533	0	1	4	4	9
OG0000534	0	0	4	5	9
OG0000535	0	0	9	0	9
OG0000536	8	0	0	0	8
OG0000537	1	1	1	5	8
OG0000538	1	1	3	3	8
OG0000539	3	3	1	1	8
OG0000540	3	2	1	2	8
OG0000541	3	1	3	1	8
OG0000542	2	1	2	3	8
OG0000543	1	2	4	1	8
OG0000544	3	1	2	2	8
OG0000545	3	1	2	2	8
OG0000546	8	0	0	0	8
OG0000547	4	1	1	2	8
OG0000548	1	1	2	4	8
OG0000549	4	0	2	2	8
OG0000550	4	2	1	1	8
OG0000551	4	1	2	1	8
OG0000552	1	1	2	4	8
OG0000553	3	1	2	2	8
OG0000554	1	2	1	4	8
OG0000555	4	1	2	1	8
OG0000556	2	1	2	3	8
OG0000557	2	1	2	3	8
OG0000558	1	5	1	1	8
OG0000559	4	1	1	2	8
OG0000560	2	1	2	3	8
OG0000561	4	1	2	1	8
OG0000562	2	1	1	4	8
OG0000563	1	3	3	1	8
OG0000564	3	2	2	1	8
OG0000565	1	1	3	3	8
OG0000566	1	1	2	4	8
OG0000567	3	2	2	1	8
OG0000568	2	4	1	1	8
OG0000569	4	1	1	2	8
OG0000570	4	1	2	1	8
OG0000571	3	1	2	2	8
OG0000572	2	2	3	1	8
OG0000573	2	2	2	2	8
OG0000574	5	1	1	1	8
OG0000575	4	1	2	1	8
OG0000576	2	1	1	4	8
OG0000577	3	1	1	3	8
OG0000578	2	3	1	2	8
OG0000579	5	0	2	1	8
OG0000580	4	1	2	1	8
OG0000581	5	1	1	1	8
OG0000582	4	1	2	1	8
OG0000583	3	1	1	3	8
OG0000584	1	1	2	4	8
OG0000585	4	2	1	1	8
OG0000586	3	3	1	1	8
OG0000587	1	1	4	2	8
OG0000588	2	2	1	3	8
OG0000589	2	1	2	3	8
OG0000590	5	1	1	1	8
OG0000591	1	1	3	3	8
OG0000592	2	1	2	3	8
OG0000593	3	2	1	2	8
OG0000594	3	1	1	3	8
OG0000595	3	1	1	3	8
OG0000596	5	1	1	1	8
OG0000597	4	1	2	1	8
OG0000598	3	1	2	2	8
OG0000599	3	1	2	2	8
OG0000600	4	1	1	2	8
OG0000601	1	1	3	3	8
OG0000602	3	1	2	2	8
OG0000603	3	1	2	2	8
OG0000604	4	1	1	2	8
OG0000605	4	1	2	1	8
OG0000606	3	1	2	2	8
OG0000607	4	1	2	1	8
OG0000608	2	0	4	2	8
OG0000609	4	1	2	1	8
OG0000610	3	1	2	2	8
OG0000611	2	2	3	1	8
OG0000612	2	1	2	3	8
OG0000613	3	1	3	1	8
OG0000614	1	3	2	2	8
OG0000615	1	2	2	3	8
OG0000616	4	1	1	2	8
OG0000617	4	2	1	1	8
OG0000618	3	1	2	2	8
OG0000619	2	1	2	3	8
OG0000620	4	1	1	2	8
OG0000621	2	1	3	2	8
OG0000622	3	1	2	2	8
OG0000623	3	3	1	1	8
OG0000624	4	1	2	1	8
OG0000625	4	1	1	2	8
OG0000626	2	1	1	4	8
OG0000627	4	1	1	2	8
OG0000628	3	1	2	2	8
OG0000629	2	1	2	3	8
OG0000630	5	1	1	1	8
OG0000631	3	1	2	2	8
OG0000632	5	1	1	1	8
OG0000633	5	1	1	1	8
OG0000634	2	1	2	3	8
OG0000635	2	4	1	1	8
OG0000636	3	1	3	1	8
OG0000637	4	1	1	2	8
OG0000638	3	1	2	2	8
OG0000639	2	1	1	4	8
OG0000640	2	1	2	3	8
OG0000641	2	1	3	2	8
OG0000642	2	1	3	2	8
OG0000643	3	1	2	2	8
OG0000644	2	1	4	1	8
OG0000645	2	1	0	5	8
OG0000646	3	1	2	2	8
OG0000647	3	1	2	2	8
OG0000648	2	3	2	1	8
OG0000649	5	1	2	0	8
OG0000650	2	1	2	3	8
OG0000651	2	1	2	3	8
OG0000652	3	1	2	2	8
OG0000653	1	1	3	3	8
OG0000654	4	1	1	2	8
OG0000655	5	0	0	3	8
OG0000656	2	1	3	2	8
OG0000657	2	2	2	2	8
OG0000658	1	1	1	5	8
OG0000659	1	1	3	3	8
OG0000660	2	1	2	3	8
OG0000661	1	1	4	2	8
OG0000662	4	1	2	1	8
OG0000663	2	1	3	2	8
OG0000664	2	1	3	2	8
OG0000665	3	2	2	1	8
OG0000666	3	1	2	2	8
OG0000667	3	0	4	1	8
OG0000668	3	1	3	1	8
OG0000669	2	1	3	2	8
OG0000670	5	1	2	0	8
OG0000671	5	1	1	1	8
OG0000672	2	1	2	3	8
OG0000673	4	1	2	1	8
OG0000674	5	0	2	1	8
OG0000675	1	1	3	3	8
OG0000676	2	0	2	4	8
OG0000677	3	1	2	2	8
OG0000678	3	0	3	2	8
OG0000679	6	1	0	1	8
OG0000680	3	1	2	2	8
OG0000681	3	1	1	3	8
OG0000682	4	1	2	1	8
OG0000683	2	1	1	4	8
OG0000684	3	1	2	2	8
OG0000685	1	2	2	3	8
OG0000686	3	1	3	1	8
OG0000687	2	1	3	2	8
OG0000688	3	1	2	2	8
OG0000689	2	2	2	2	8
OG0000690	8	0	0	0	8
OG0000691	2	0	3	3	8
OG0000692	2	1	2	3	8
OG0000693	1	1	3	3	8
OG0000694	4	1	2	1	8
OG0000695	4	1	2	1	8
OG0000696	5	1	1	1	8
OG0000697	3	1	2	2	8
OG0000698	4	0	2	2	8
OG0000699	1	1	4	2	8
OG0000700	1	1	3	3	8
OG0000701	2	2	2	2	8
OG0000702	2	1	1	4	8
OG0000703	2	1	4	1	8
OG0000704	3	1	2	2	8
OG0000705	2	1	2	3	8
OG0000706	5	1	1	1	8
OG0000707	1	1	1	5	8
OG0000708	3	1	2	2	8
OG0000709	4	1	2	1	8
OG0000710	3	1	2	2	8
OG0000711	3	1	2	2	8
OG0000712	3	1	2	2	8
OG0000713	2	1	1	4	8
OG0000714	3	1	1	3	8
OG0000715	1	1	3	3	8
OG0000716	4	1	0	3	8
OG0000717	5	1	1	1	8
OG0000718	4	1	2	1	8
OG0000719	4	1	2	1	8
OG0000720	3	1	1	3	8
OG0000721	3	3	1	1	8
OG0000722	4	1	2	1	8
OG0000723	1	2	2	3	8
OG0000724	2	1	1	4	8
OG0000725	2	1	2	3	8
OG0000726	1	1	2	4	8
OG0000727	3	1	1	3	8
OG0000728	1	2	3	2	8
OG0000729	2	1	3	2	8
OG0000730	1	1	3	3	8
OG0000731	2	2	1	3	8
OG0000732	1	1	2	4	8
OG0000733	5	1	1	1	8
OG0000734	3	1	2	2	8
OG0000735	4	1	2	1	8
OG0000736	3	1	2	2	8
OG0000737	5	1	1	1	8
OG0000738	3	1	2	2	8
OG0000739	4	1	1	2	8
OG0000740	2	1	2	3	8
OG0000741	2	2	2	2	8
OG0000742	2	1	2	3	8
OG0000743	3	1	2	2	8
OG0000744	5	1	1	1	8
OG0000745	2	1	2	3	8
OG0000746	5	1	1	1	8
OG0000747	4	1	2	1	8
OG0000748	4	1	2	1	8
OG0000749	1	1	2	4	8
OG0000750	5	1	1	1	8
OG0000751	5	1	1	1	8
OG0000752	5	1	2	0	8
OG0000753	1	2	2	3	8
OG0000754	6	1	0	1	8
OG0000755	4	1	2	1	8
OG0000756	3	1	2	2	8
OG0000757	2	1	2	3	8
OG0000758	3	1	1	3	8
OG0000759	2	1	3	2	8
OG0000760	2	2	2	2	8
OG0000761	1	1	3	3	8
OG0000762	3	1	2	2	8
OG0000763	3	1	2	2	8
OG0000764	1	0	0	7	8
OG0000765	4	2	1	1	8
OG0000766	2	1	1	4	8
OG0000767	3	1	2	2	8
OG0000768	5	1	1	1	8
OG0000769	1	1	3	3	8
OG0000770	2	3	1	2	8
OG0000771	1	2	1	4	8
OG0000772	1	1	2	4	8
OG0000773	1	1	3	3	8
OG0000774	1	1	1	5	8
OG0000775	1	2	3	2	8
OG0000776	1	1	2	4	8
OG0000777	1	1	2	4	8
OG0000778	0	8	0	0	8
OG0000779	0	3	3	2	8
OG0000780	0	1	2	5	8
OG0000781	0	1	2	5	8
OG0000782	0	4	1	3	8
OG0000783	0	1	4	3	8
OG0000784	0	4	2	2	8
OG0000785	0	2	2	4	8
OG0000786	0	4	1	3	8
OG0000787	0	2	2	4	8
OG0000788	0	1	3	4	8
OG0000789	0	1	5	2	8
OG0000790	0	1	4	3	8
OG0000791	0	1	2	5	8
OG0000792	0	1	4	3	8
OG0000793	0	0	6	2	8
OG0000794	0	0	7	1	8
OG0000795	0	0	0	8	8
OG0000796	0	0	0	8	8
OG0000797	1	3	1	2	7
OG0000798	4	1	1	1	7
OG0000799	1	3	2	1	7
OG0000800	2	2	1	2	7
OG0000801	1	2	2	2	7
OG0000802	3	0	1	3	7
OG0000803	2	1	3	1	7
OG0000804	4	1	1	1	7
OG0000805	2	1	2	2	7
OG0000806	3	1	2	1	7
OG0000807	3	1	1	2	7
OG0000808	3	1	1	2	7
OG0000809	5	0	1	1	7
OG0000810	2	1	2	2	7
OG0000811	1	4	1	1	7
OG0000812	1	1	2	3	7
OG0000813	1	2	2	2	7
OG0000814	2	1	2	2	7
OG0000815	3	1	2	1	7
OG0000816	3	1	1	2	7
OG0000817	2	1	2	2	7
OG0000818	1	2	2	2	7
OG0000819	1	2	1	3	7
OG0000820	4	1	1	1	7
OG0000821	2	3	1	1	7
OG0000822	2	1	1	3	7
OG0000823	2	1	1	3	7
OG0000824	1	1	2	3	7
OG0000825	3	1	2	1	7
OG0000826	2	1	3	1	7
OG0000827	2	1	3	1	7
OG0000828	3	1	1	2	7
OG0000829	3	1	2	1	7
OG0000830	3	1	1	2	7
OG0000831	3	2	1	1	7
OG0000832	1	1	2	3	7
OG0000833	3	1	3	0	7
OG0000834	2	2	1	2	7
OG0000835	3	1	1	2	7
OG0000836	2	2	2	1	7
OG0000837	3	1	2	1	7
OG0000838	2	1	2	2	7
OG0000839	2	1	3	1	7
OG0000840	1	1	3	2	7
OG0000841	2	1	2	2	7
OG0000842	2	3	1	1	7
OG0000843	5	1	0	1	7
OG0000844	4	1	1	1	7
OG0000845	3	1	1	2	7
OG0000846	1	1	3	2	7
OG0000847	3	1	2	1	7
OG0000848	3	1	1	2	7
OG0000849	2	0	1	4	7
OG0000850	2	1	2	2	7
OG0000851	2	1	2	2	7
OG0000852	2	3	1	1	7
OG0000853	2	1	2	2	7
OG0000854	1	3	2	1	7
OG0000855	2	1	2	2	7
OG0000856	4	1	1	1	7
OG0000857	1	1	2	3	7
OG0000858	2	3	1	1	7
OG0000859	3	1	2	1	7
OG0000860	2	1	1	3	7
OG0000861	1	2	1	3	7
OG0000862	2	1	1	3	7
OG0000863	3	1	2	1	7
OG0000864	1	1	3	2	7
OG0000865	1	1	1	4	7
OG0000866	2	1	2	2	7
OG0000867	3	1	1	2	7
OG0000868	3	1	2	1	7
OG0000869	3	1	2	1	7
OG0000870	2	1	2	2	7
OG0000871	1	1	3	2	7
OG0000872	4	1	1	1	7
OG0000873	3	1	1	2	7
OG0000874	2	1	2	2	7
OG0000875	3	1	1	2	7
OG0000876	1	1	2	3	7
OG0000877	7	0	0	0	7
OG0000878	3	1	1	2	7
OG0000879	4	1	1	1	7
OG0000880	3	1	1	2	7
OG0000881	2	1	2	2	7
OG0000882	3	1	2	1	7
OG0000883	3	1	2	1	7
OG0000884	2	1	2	2	7
OG0000885	3	1	1	2	7
OG0000886	3	1	2	1	7
OG0000887	2	1	2	2	7
OG0000888	3	1	2	1	7
OG0000889	2	1	3	1	7
OG0000890	3	1	1	2	7
OG0000891	4	1	1	1	7
OG0000892	2	1	2	2	7
OG0000893	1	1	2	3	7
OG0000894	4	1	2	0	7
OG0000895	2	0	2	3	7
OG0000896	1	0	1	5	7
OG0000897	2	1	2	2	7
OG0000898	1	3	2	1	7
OG0000899	2	1	2	2	7
OG0000900	3	0	2	2	7
OG0000901	2	1	3	1	7
OG0000902	3	1	1	2	7
OG0000903	4	1	1	1	7
OG0000904	3	1	2	1	7
OG0000905	3	1	2	1	7
OG0000906	3	1	2	1	7
OG0000907	3	1	1	2	7
OG0000908	1	3	1	2	7
OG0000909	1	2	2	2	7
OG0000910	1	3	1	2	7
OG0000911	1	1	2	3	7
OG0000912	1	1	0	5	7
OG0000913	1	1	1	4	7
OG0000914	3	1	2	1	7
OG0000915	3	1	1	2	7
OG0000916	2	1	2	2	7
OG0000917	3	1	2	1	7
OG0000918	1	1	3	2	7
OG0000919	3	2	0	2	7
OG0000920	2	1	3	1	7
OG0000921	1	1	1	4	7
OG0000922	5	1	0	1	7
OG0000923	4	1	1	1	7
OG0000924	3	2	1	1	7
OG0000925	1	1	2	3	7
OG0000926	4	1	1	1	7
OG0000927	3	1	1	2	7
OG0000928	1	1	1	4	7
OG0000929	3	1	1	2	7
OG0000930	2	2	2	1	7
OG0000931	1	1	1	4	7
OG0000932	2	1	3	1	7
OG0000933	2	1	2	2	7
OG0000934	2	2	1	2	7
OG0000935	2	1	2	2	7
OG0000936	2	1	1	3	7
OG0000937	3	1	1	2	7
OG0000938	2	1	2	2	7
OG0000939	2	1	2	2	7
OG0000940	2	1	2	2	7
OG0000941	2	2	2	1	7
OG0000942	2	1	3	1	7
OG0000943	3	1	1	2	7
OG0000944	2	1	1	3	7
OG0000945	2	1	0	4	7
OG0000946	2	1	2	2	7
OG0000947	3	1	2	1	7
OG0000948	4	1	1	1	7
OG0000949	1	1	2	3	7
OG0000950	3	1	3	0	7
OG0000951	1	1	2	3	7
OG0000952	3	1	2	1	7
OG0000953	4	1	1	1	7
OG0000954	2	1	1	3	7
OG0000955	2	1	2	2	7
OG0000956	1	2	1	3	7
OG0000957	4	1	1	1	7
OG0000958	1	1	3	2	7
OG0000959	4	1	1	1	7
OG0000960	2	1	3	1	7
OG0000961	4	1	1	1	7
OG0000962	2	1	2	2	7
OG0000963	2	1	3	1	7
OG0000964	3	1	2	1	7
OG0000965	2	1	1	3	7
OG0000966	3	1	1	2	7
OG0000967	2	1	2	2	7
OG0000968	4	1	2	0	7
OG0000969	3	1	2	1	7
OG0000970	2	1	3	1	7
OG0000971	4	1	1	1	7
OG0000972	2	1	1	3	7
OG0000973	2	1	2	2	7
OG0000974	5	1	1	0	7
OG0000975	4	1	1	1	7
OG0000976	3	1	1	2	7
OG0000977	2	1	2	2	7
OG0000978	3	1	2	1	7
OG0000979	3	1	2	1	7
OG0000980	2	1	1	3	7
OG0000981	1	1	2	3	7
OG0000982	2	1	2	2	7
OG0000983	2	1	1	3	7
OG0000984	4	1	1	1	7
OG0000985	6	1	0	0	7
OG0000986	2	1	1	3	7
OG0000987	2	1	2	2	7
OG0000988	2	1	2	2	7
OG0000989	3	2	2	0	7
OG0000990	2	2	1	2	7
OG0000991	3	1	1	2	7
OG0000992	3	1	2	1	7
OG0000993	2	1	2	2	7
OG0000994	3	1	1	2	7
OG0000995	2	1	3	1	7
OG0000996	3	1	1	2	7
OG0000997	3	2	0	2	7
OG0000998	2	1	1	3	7
OG0000999	1	1	2	3	7
OG0001000	3	1	1	2	7
OG0001001	2	0	2	3	7
OG0001002	5	1	1	0	7
OG0001003	3	1	2	1	7
OG0001004	5	1	0	1	7
OG0001005	2	1	2	2	7
OG0001006	4	1	1	1	7
OG0001007	3	1	1	2	7
OG0001008	2	1	1	3	7
OG0001009	1	1	3	2	7
OG0001010	5	1	1	0	7
OG0001011	2	2	1	2	7
OG0001012	3	1	2	1	7
OG0001013	2	1	3	1	7
OG0001014	1	1	2	3	7
OG0001015	1	1	4	1	7
OG0001016	5	0	1	1	7
OG0001017	4	1	1	1	7
OG0001018	1	1	3	2	7
OG0001019	3	1	2	1	7
OG0001020	3	1	2	1	7
OG0001021	2	1	4	0	7
OG0001022	3	2	1	1	7
OG0001023	1	2	3	1	7
OG0001024	1	1	3	2	7
OG0001025	2	1	3	1	7
OG0001026	2	1	2	2	7
OG0001027	1	1	2	3	7
OG0001028	3	1	2	1	7
OG0001029	2	1	2	2	7
OG0001030	1	1	4	1	7
OG0001031	1	1	3	2	7
OG0001032	2	1	2	2	7
OG0001033	5	1	1	0	7
OG0001034	2	1	2	2	7
OG0001035	2	1	2	2	7
OG0001036	2	2	2	1	7
OG0001037	2	2	1	2	7
OG0001038	4	1	0	2	7
OG0001039	2	1	2	2	7
OG0001040	2	1	3	1	7
OG0001041	3	1	2	1	7
OG0001042	3	1	0	3	7
OG0001043	3	1	1	2	7
OG0001044	2	2	2	1	7
OG0001045	2	1	1	3	7
OG0001046	4	0	0	3	7
OG0001047	3	1	2	1	7
OG0001048	2	1	2	2	7
OG0001049	2	1	2	2	7
OG0001050	4	1	1	1	7
OG0001051	3	1	2	1	7
OG0001052	2	1	1	3	7
OG0001053	1	1	3	2	7
OG0001054	2	1	2	2	7
OG0001055	2	1	2	2	7
OG0001056	1	1	1	4	7
OG0001057	3	1	1	2	7
OG0001058	2	1	2	2	7
OG0001059	3	0	2	2	7
OG0001060	2	1	2	2	7
OG0001061	2	1	2	2	7
OG0001062	1	3	2	1	7
OG0001063	1	1	2	3	7
OG0001064	2	1	1	3	7
OG0001065	4	1	1	1	7
OG0001066	4	1	1	1	7
OG0001067	1	1	3	2	7
OG0001068	1	1	4	1	7
OG0001069	3	0	3	1	7
OG0001070	1	1	3	2	7
OG0001071	1	1	2	3	7
OG0001072	3	1	1	2	7
OG0001073	3	1	2	1	7
OG0001074	4	1	1	1	7
OG0001075	2	1	2	2	7
OG0001076	2	0	4	1	7
OG0001077	2	1	2	2	7
OG0001078	2	1	3	1	7
OG0001079	1	1	2	3	7
OG0001080	3	1	1	2	7
OG0001081	4	1	1	1	7
OG0001082	2	1	2	2	7
OG0001083	2	2	1	2	7
OG0001084	1	1	2	3	7
OG0001085	5	1	0	1	7
OG0001086	2	1	2	2	7
OG0001087	2	1	2	2	7
OG0001088	3	1	2	1	7
OG0001089	1	1	1	4	7
OG0001090	3	1	1	2	7
OG0001091	1	1	2	3	7
OG0001092	3	1	2	1	7
OG0001093	2	1	1	3	7
OG0001094	4	1	1	1	7
OG0001095	2	1	2	2	7
OG0001096	1	1	1	4	7
OG0001097	1	3	1	2	7
OG0001098	2	1	3	1	7
OG0001099	4	1	1	1	7
OG0001100	1	4	1	1	7
OG0001101	2	1	2	2	7
OG0001102	3	2	1	1	7
OG0001103	3	1	1	2	7
OG0001104	2	1	1	3	7
OG0001105	2	2	2	1	7
OG0001106	1	1	4	1	7
OG0001107	2	1	1	3	7
OG0001108	2	1	2	2	7
OG0001109	4	1	1	1	7
OG0001110	1	3	2	1	7
OG0001111	2	2	3	0	7
OG0001112	3	1	2	1	7
OG0001113	2	1	2	2	7
OG0001114	1	1	5	0	7
OG0001115	2	2	2	1	7
OG0001116	1	1	3	2	7
OG0001117	3	1	1	2	7
OG0001118	1	1	2	3	7
OG0001119	4	1	1	1	7
OG0001120	1	1	2	3	7
OG0001121	3	1	1	2	7
OG0001122	5	1	1	0	7
OG0001123	1	4	1	1	7
OG0001124	3	1	1	2	7
OG0001125	2	1	2	2	7
OG0001126	3	1	1	2	7
OG0001127	3	1	2	1	7
OG0001128	1	1	2	3	7
OG0001129	4	1	1	1	7
OG0001130	4	1	1	1	7
OG0001131	1	1	3	2	7
OG0001132	1	4	1	1	7
OG0001133	2	0	3	2	7
OG0001134	2	1	2	2	7
OG0001135	4	1	1	1	7
OG0001136	2	1	2	2	7
OG0001137	3	1	1	2	7
OG0001138	1	1	2	3	7
OG0001139	4	1	1	1	7
OG0001140	1	0	3	3	7
OG0001141	2	1	2	2	7
OG0001142	1	2	2	2	7
OG0001143	1	1	3	2	7
OG0001144	1	1	2	3	7
OG0001145	2	1	3	1	7
OG0001146	1	3	0	3	7
OG0001147	3	1	3	0	7
OG0001148	2	3	2	0	7
OG0001149	2	1	3	1	7
OG0001150	2	1	2	2	7
OG0001151	2	1	3	1	7
OG0001152	1	1	3	2	7
OG0001153	2	3	1	1	7
OG0001154	2	2	2	1	7
OG0001155	1	1	3	2	7
OG0001156	1	2	3	1	7
OG0001157	1	1	2	3	7
OG0001158	1	1	3	2	7
OG0001159	1	1	2	3	7
OG0001160	1	1	2	3	7
OG0001161	1	1	3	2	7
OG0001162	1	4	1	1	7
OG0001163	1	1	3	2	7
OG0001164	1	1	3	2	7
OG0001165	1	4	1	1	7
OG0001166	2	2	2	1	7
OG0001167	1	1	2	3	7
OG0001168	1	2	2	2	7
OG0001169	1	1	2	3	7
OG0001170	1	3	2	1	7
OG0001171	1	5	0	1	7
OG0001172	0	2	2	3	7
OG0001173	0	7	0	0	7
OG0001174	0	1	1	5	7
OG0001175	0	7	0	0	7
OG0001176	0	1	2	4	7
OG0001177	0	1	3	3	7
OG0001178	0	2	3	2	7
OG0001179	0	6	1	0	7
OG0001180	0	4	2	1	7
OG0001181	0	1	3	3	7
OG0001182	0	3	1	3	7
OG0001183	0	5	0	2	7
OG0001184	0	3	3	1	7
OG0001185	0	3	2	2	7
OG0001186	0	1	2	4	7
OG0001187	0	1	2	4	7
OG0001188	0	3	2	2	7
OG0001189	0	1	2	4	7
OG0001190	0	1	5	1	7
OG0001191	0	1	4	2	7
OG0001192	0	2	4	1	7
OG0001193	0	1	1	5	7
OG0001194	0	2	2	3	7
OG0001195	0	2	2	3	7
OG0001196	0	1	2	4	7
OG0001197	0	1	2	4	7
OG0001198	0	1	5	1	7
OG0001199	0	1	5	1	7
OG0001200	0	1	2	4	7
OG0001201	0	1	2	4	7
OG0001202	0	1	1	5	7
OG0001203	0	1	4	2	7
OG0001204	0	1	0	6	7
OG0001205	0	1	4	2	7
OG0001206	0	1	2	4	7
OG0001207	0	1	4	2	7
OG0001208	0	0	3	4	7
OG0001209	0	0	6	1	7
OG0001210	0	0	1	6	7
OG0001211	0	0	3	4	7
OG0001212	0	0	6	1	7
OG0001213	0	0	3	4	7
OG0001214	0	0	0	7	7
OG0001215	1	1	2	2	6
OG0001216	1	3	1	1	6
OG0001217	2	1	2	1	6
OG0001218	1	1	1	3	6
OG0001219	2	1	2	1	6
OG0001220	2	1	1	2	6
OG0001221	2	1	2	1	6
OG0001222	2	2	2	0	6
OG0001223	4	0	0	2	6
OG0001224	2	1	1	2	6
OG0001225	2	1	2	1	6
OG0001226	1	1	2	2	6
OG0001227	2	2	1	1	6
OG0001228	2	2	1	1	6
OG0001229	2	1	1	2	6
OG0001230	4	1	0	1	6
OG0001231	1	1	2	2	6
OG0001232	2	1	2	1	6
OG0001233	1	1	2	2	6
OG0001234	3	1	1	1	6
OG0001235	1	2	2	1	6
OG0001236	1	4	1	0	6
OG0001237	2	1	1	2	6
OG0001238	1	1	2	2	6
OG0001239	2	1	1	2	6
OG0001240	3	1	1	1	6
OG0001241	1	3	1	1	6
OG0001242	2	1	2	1	6
OG0001243	2	1	2	1	6
OG0001244	1	3	1	1	6
OG0001245	2	3	1	0	6
OG0001246	2	1	1	2	6
OG0001247	3	1	1	1	6
OG0001248	2	1	2	1	6
OG0001249	2	2	1	1	6
OG0001250	2	1	2	1	6
OG0001251	2	0	1	3	6
OG0001252	3	1	1	1	6
OG0001253	3	1	1	1	6
OG0001254	3	1	1	1	6
OG0001255	3	1	1	1	6
OG0001256	2	1	1	2	6
OG0001257	3	1	1	1	6
OG0001258	2	1	1	2	6
OG0001259	1	2	1	2	6
OG0001260	1	1	2	2	6
OG0001261	3	0	2	1	6
OG0001262	4	0	1	1	6
OG0001263	2	1	2	1	6
OG0001264	2	1	2	1	6
OG0001265	1	1	1	3	6
OG0001266	1	1	1	3	6
OG0001267	3	1	1	1	6
OG0001268	3	1	1	1	6
OG0001269	2	2	2	0	6
OG0001270	3	1	1	1	6
OG0001271	1	2	2	1	6
OG0001272	1	2	2	1	6
OG0001273	1	3	1	1	6
OG0001274	1	1	2	2	6
OG0001275	2	1	1	2	6
OG0001276	2	1	2	1	6
OG0001277	1	1	2	2	6
OG0001278	2	1	1	2	6
OG0001279	2	3	1	0	6
OG0001280	2	1	2	1	6
OG0001281	1	1	1	3	6
OG0001282	3	1	1	1	6
OG0001283	1	1	3	1	6
OG0001284	2	1	1	2	6
OG0001285	1	2	2	1	6
OG0001286	2	1	2	1	6
OG0001287	1	2	1	2	6
OG0001288	1	1	2	2	6
OG0001289	2	1	2	1	6
OG0001290	2	1	2	1	6
OG0001291	2	1	2	1	6
OG0001292	2	0	1	3	6
OG0001293	2	1	2	1	6
OG0001294	2	1	1	2	6
OG0001295	2	1	2	1	6
OG0001296	2	1	2	1	6
OG0001297	3	1	1	1	6
OG0001298	1	2	1	2	6
OG0001299	1	1	3	1	6
OG0001300	1	1	3	1	6
OG0001301	1	1	2	2	6
OG0001302	3	1	1	1	6
OG0001303	2	1	1	2	6
OG0001304	3	1	1	1	6
OG0001305	3	1	1	1	6
OG0001306	4	1	1	0	6
OG0001307	2	1	1	2	6
OG0001308	2	2	0	2	6
OG0001309	1	1	2	2	6
OG0001310	2	1	1	2	6
OG0001311	2	1	2	1	6
OG0001312	3	1	0	2	6
OG0001313	4	1	0	1	6
OG0001314	2	1	1	2	6
OG0001315	2	1	1	2	6
OG0001316	2	1	1	2	6
OG0001317	2	3	0	1	6
OG0001318	2	1	1	2	6
OG0001319	3	1	1	1	6
OG0001320	2	2	1	1	6
OG0001321	1	1	2	2	6
OG0001322	3	1	1	1	6
OG0001323	3	1	2	0	6
OG0001324	2	1	2	1	6
OG0001325	1	1	1	3	6
OG0001326	3	1	1	1	6
OG0001327	2	1	1	2	6
OG0001328	2	1	1	2	6
OG0001329	3	1	1	1	6
OG0001330	2	1	1	2	6
OG0001331	3	1	1	1	6
OG0001332	4	1	1	0	6
OG0001333	2	1	1	2	6
OG0001334	2	1	3	0	6
OG0001335	1	1	2	2	6
OG0001336	2	0	2	2	6
OG0001337	4	1	1	0	6
OG0001338	3	1	1	1	6
OG0001339	2	1	2	1	6
OG0001340	1	2	1	2	6
OG0001341	2	1	1	2	6
OG0001342	3	1	1	1	6
OG0001343	3	1	1	1	6
OG0001344	3	1	1	1	6
OG0001345	2	1	2	1	6
OG0001346	2	1	1	2	6
OG0001347	2	1	1	2	6
OG0001348	1	1	3	1	6
OG0001349	1	2	2	1	6
OG0001350	2	1	2	1	6
OG0001351	2	1	2	1	6
OG0001352	2	1	2	1	6
OG0001353	3	1	1	1	6
OG0001354	2	1	1	2	6
OG0001355	3	1	1	1	6
OG0001356	1	1	1	3	6
OG0001357	1	3	1	1	6
OG0001358	4	1	0	1	6
OG0001359	2	1	2	1	6
OG0001360	2	1	1	2	6
OG0001361	2	1	1	2	6
OG0001362	2	2	1	1	6
OG0001363	2	2	1	1	6
OG0001364	1	1	1	3	6
OG0001365	1	1	1	3	6
OG0001366	3	1	1	1	6
OG0001367	1	1	2	2	6
OG0001368	2	1	2	1	6
OG0001369	1	1	1	3	6
OG0001370	6	0	0	0	6
OG0001371	2	2	1	1	6
OG0001372	3	1	1	1	6
OG0001373	1	1	3	1	6
OG0001374	2	1	1	2	6
OG0001375	1	1	3	1	6
OG0001376	2	1	1	2	6
OG0001377	3	1	1	1	6
OG0001378	2	1	1	2	6
OG0001379	2	1	2	1	6
OG0001380	3	2	0	1	6
OG0001381	4	1	1	0	6
OG0001382	3	1	1	1	6
OG0001383	3	1	0	2	6
OG0001384	3	1	1	1	6
OG0001385	1	2	2	1	6
OG0001386	2	1	2	1	6
OG0001387	3	0	1	2	6
OG0001388	2	1	1	2	6
OG0001389	2	1	2	1	6
OG0001390	2	1	2	1	6
OG0001391	3	1	1	1	6
OG0001392	3	1	1	1	6
OG0001393	1	2	1	2	6
OG0001394	1	2	1	2	6
OG0001395	3	1	2	0	6
OG0001396	2	1	2	1	6
OG0001397	1	1	2	2	6
OG0001398	1	1	2	2	6
OG0001399	2	1	2	1	6
OG0001400	2	1	1	2	6
OG0001401	2	1	1	2	6
OG0001402	2	1	2	1	6
OG0001403	1	1	3	1	6
OG0001404	2	1	1	2	6
OG0001405	1	1	2	2	6
OG0001406	3	1	1	1	6
OG0001407	1	1	0	4	6
OG0001408	2	1	2	1	6
OG0001409	1	1	2	2	6
OG0001410	1	1	2	2	6
OG0001411	2	1	2	1	6
OG0001412	2	1	1	2	6
OG0001413	2	1	2	1	6
OG0001414	1	1	1	3	6
OG0001415	1	1	1	3	6
OG0001416	1	1	1	3	6
OG0001417	4	1	0	1	6
OG0001418	2	2	1	1	6
OG0001419	2	0	1	3	6
OG0001420	3	1	2	0	6
OG0001421	1	1	2	2	6
OG0001422	1	1	2	2	6
OG0001423	2	1	1	2	6
OG0001424	1	1	2	2	6
OG0001425	1	1	2	2	6
OG0001426	3	1	1	1	6
OG0001427	2	0	3	1	6
OG0001428	3	1	1	1	6
OG0001429	2	1	1	2	6
OG0001430	2	1	1	2	6
OG0001431	2	1	1	2	6
OG0001432	1	1	2	2	6
OG0001433	2	1	2	1	6
OG0001434	1	2	1	2	6
OG0001435	1	1	3	1	6
OG0001436	2	1	2	1	6
OG0001437	1	1	2	2	6
OG0001438	1	1	2	2	6
OG0001439	1	1	1	3	6
OG0001440	2	1	1	2	6
OG0001441	3	1	1	1	6
OG0001442	2	1	1	2	6
OG0001443	1	3	1	1	6
OG0001444	2	1	2	1	6
OG0001445	2	1	2	1	6
OG0001446	3	1	1	1	6
OG0001447	1	1	1	3	6
OG0001448	1	1	3	1	6
OG0001449	1	1	2	2	6
OG0001450	2	1	2	1	6
OG0001451	1	2	2	1	6
OG0001452	2	1	2	1	6
OG0001453	1	1	2	2	6
OG0001454	3	0	1	2	6
OG0001455	1	1	2	2	6
OG0001456	1	1	2	2	6
OG0001457	2	1	2	1	6
OG0001458	3	1	1	1	6
OG0001459	1	1	3	1	6
OG0001460	3	1	1	1	6
OG0001461	2	1	1	2	6
OG0001462	4	0	1	1	6
OG0001463	3	1	1	1	6
OG0001464	3	1	0	2	6
OG0001465	3	1	2	0	6
OG0001466	2	1	1	2	6
OG0001467	3	1	1	1	6
OG0001468	3	1	1	1	6
OG0001469	2	2	1	1	6
OG0001470	2	1	1	2	6
OG0001471	2	1	2	1	6
OG0001472	2	1	1	2	6
OG0001473	1	1	2	2	6
OG0001474	4	0	1	1	6
OG0001475	4	1	0	1	6
OG0001476	2	1	2	1	6
OG0001477	2	1	1	2	6
OG0001478	2	1	1	2	6
OG0001479	1	1	2	2	6
OG0001480	3	0	1	2	6
OG0001481	3	1	1	1	6
OG0001482	1	1	2	2	6
OG0001483	1	1	1	3	6
OG0001484	2	1	2	1	6
OG0001485	1	1	2	2	6
OG0001486	3	1	1	1	6
OG0001487	3	1	1	1	6
OG0001488	2	0	2	2	6
OG0001489	2	1	1	2	6
OG0001490	3	1	1	1	6
OG0001491	1	2	1	2	6
OG0001492	2	1	1	2	6
OG0001493	2	1	2	1	6
OG0001494	2	1	1	2	6
OG0001495	1	1	2	2	6
OG0001496	1	1	2	2	6
OG0001497	2	2	1	1	6
OG0001498	2	1	2	1	6
OG0001499	3	1	1	1	6
OG0001500	3	1	2	0	6
OG0001501	1	1	3	1	6
OG0001502	3	1	1	1	6
OG0001503	2	1	1	2	6
OG0001504	2	1	1	2	6
OG0001505	2	1	1	2	6
OG0001506	2	1	2	1	6
OG0001507	3	1	2	0	6
OG0001508	3	1	1	1	6
OG0001509	4	0	1	1	6
OG0001510	3	1	1	1	6
OG0001511	3	1	1	1	6
OG0001512	2	1	3	0	6
OG0001513	1	1	3	1	6
OG0001514	2	1	2	1	6
OG0001515	2	1	1	2	6
OG0001516	3	1	1	1	6
OG0001517	2	1	1	2	6
OG0001518	1	1	2	2	6
OG0001519	2	1	1	2	6
OG0001520	3	1	1	1	6
OG0001521	6	0	0	0	6
OG0001522	2	1	1	2	6
OG0001523	1	1	1	3	6
OG0001524	3	1	1	1	6
OG0001525	2	1	2	1	6
OG0001526	3	1	1	1	6
OG0001527	1	1	2	2	6
OG0001528	1	1	2	2	6
OG0001529	2	1	1	2	6
OG0001530	2	1	1	2	6
OG0001531	2	1	1	2	6
OG0001532	2	2	1	1	6
OG0001533	2	1	2	1	6
OG0001534	1	1	2	2	6
OG0001535	3	2	1	0	6
OG0001536	2	1	2	1	6
OG0001537	4	0	1	1	6
OG0001538	4	1	0	1	6
OG0001539	2	1	1	2	6
OG0001540	1	1	1	3	6
OG0001541	3	1	0	2	6
OG0001542	1	1	3	1	6
OG0001543	2	1	2	1	6
OG0001544	2	1	2	1	6
OG0001545	1	1	1	3	6
OG0001546	1	1	2	2	6
OG0001547	3	1	1	1	6
OG0001548	3	1	1	1	6
OG0001549	1	3	1	1	6
OG0001550	2	1	2	1	6
OG0001551	2	1	2	1	6
OG0001552	2	1	1	2	6
OG0001553	2	1	1	2	6
OG0001554	2	1	1	2	6
OG0001555	2	1	2	1	6
OG0001556	3	1	1	1	6
OG0001557	3	1	2	0	6
OG0001558	1	1	1	3	6
OG0001559	2	1	1	2	6
OG0001560	1	1	2	2	6
OG0001561	2	2	1	1	6
OG0001562	2	1	1	2	6
OG0001563	2	1	2	1	6
OG0001564	2	1	1	2	6
OG0001565	1	1	2	2	6
OG0001566	1	1	2	2	6
OG0001567	2	1	2	1	6
OG0001568	2	1	2	1	6
OG0001569	3	1	1	1	6
OG0001570	1	1	1	3	6
OG0001571	2	1	1	2	6
OG0001572	1	1	2	2	6
OG0001573	1	1	1	3	6
OG0001574	2	1	1	2	6
OG0001575	2	1	1	2	6
OG0001576	2	1	1	2	6
OG0001577	1	2	2	1	6
OG0001578	2	1	1	2	6
OG0001579	3	1	1	1	6
OG0001580	1	1	2	2	6
OG0001581	1	2	1	2	6
OG0001582	1	1	0	4	6
OG0001583	3	1	0	2	6
OG0001584	2	1	0	3	6
OG0001585	3	1	1	1	6
OG0001586	1	1	2	2	6
OG0001587	2	1	1	2	6
OG0001588	2	1	2	1	6
OG0001589	3	1	1	1	6
OG0001590	1	1	3	1	6
OG0001591	3	1	1	1	6
OG0001592	2	1	1	2	6
OG0001593	1	2	2	1	6
OG0001594	6	0	0	0	6
OG0001595	3	1	1	1	6
OG0001596	2	1	2	1	6
OG0001597	1	1	1	3	6
OG0001598	3	1	2	0	6
OG0001599	1	1	2	2	6
OG0001600	1	1	1	3	6
OG0001601	2	1	2	1	6
OG0001602	3	1	1	1	6
OG0001603	2	1	2	1	6
OG0001604	2	1	2	1	6
OG0001605	2	1	2	1	6
OG0001606	4	1	0	1	6
OG0001607	2	1	2	1	6
OG0001608	2	1	2	1	6
OG0001609	1	4	0	1	6
OG0001610	2	1	2	1	6
OG0001611	1	2	1	2	6
OG0001612	2	1	2	1	6
OG0001613	2	1	1	2	6
OG0001614	1	1	2	2	6
OG0001615	2	1	1	2	6
OG0001616	1	1	2	2	6
OG0001617	3	1	1	1	6
OG0001618	1	1	2	2	6
OG0001619	2	2	1	1	6
OG0001620	2	2	0	2	6
OG0001621	1	1	2	2	6
OG0001622	3	1	1	1	6
OG0001623	2	1	1	2	6
OG0001624	1	1	3	1	6
OG0001625	2	1	1	2	6
OG0001626	4	0	1	1	6
OG0001627	1	1	2	2	6
OG0001628	1	1	2	2	6
OG0001629	1	1	2	2	6
OG0001630	3	1	1	1	6
OG0001631	1	2	2	1	6
OG0001632	2	1	1	2	6
OG0001633	1	1	1	3	6
OG0001634	1	1	3	1	6
OG0001635	1	1	2	2	6
OG0001636	1	1	2	2	6
OG0001637	1	1	2	2	6
OG0001638	3	1	1	1	6
OG0001639	1	1	2	2	6
OG0001640	1	1	3	1	6
OG0001641	2	1	1	2	6
OG0001642	2	1	1	2	6
OG0001643	1	0	1	4	6
OG0001644	3	1	1	1	6
OG0001645	1	2	2	1	6
OG0001646	2	1	3	0	6
OG0001647	1	1	2	2	6
OG0001648	2	1	3	0	6
OG0001649	2	1	2	1	6
OG0001650	2	1	1	2	6
OG0001651	2	1	1	2	6
OG0001652	1	2	2	1	6
OG0001653	4	1	0	1	6
OG0001654	6	0	0	0	6
OG0001655	1	1	2	2	6
OG0001656	1	1	3	1	6
OG0001657	1	0	2	3	6
OG0001658	1	1	1	3	6
OG0001659	1	1	2	2	6
OG0001660	2	1	2	1	6
OG0001661	3	1	1	1	6
OG0001662	2	1	1	2	6
OG0001663	1	1	2	2	6
OG0001664	3	1	0	2	6
OG0001665	3	1	1	1	6
OG0001666	1	1	1	3	6
OG0001667	2	1	2	1	6
OG0001668	2	1	1	2	6
OG0001669	3	1	0	2	6
OG0001670	2	0	3	1	6
OG0001671	1	1	1	3	6
OG0001672	3	1	1	1	6
OG0001673	2	1	2	1	6
OG0001674	2	1	2	1	6
OG0001675	1	1	1	3	6
OG0001676	1	1	1	3	6
OG0001677	1	3	1	1	6
OG0001678	2	0	1	3	6
OG0001679	6	0	0	0	6
OG0001680	3	1	1	1	6
OG0001681	3	1	1	1	6
OG0001682	4	1	1	0	6
OG0001683	1	2	1	2	6
OG0001684	2	1	1	2	6
OG0001685	1	3	1	1	6
OG0001686	2	1	2	1	6
OG0001687	1	1	2	2	6
OG0001688	1	2	1	2	6
OG0001689	1	1	3	1	6
OG0001690	2	1	1	2	6
OG0001691	2	1	1	2	6
OG0001692	2	1	1	2	6
OG0001693	2	1	1	2	6
OG0001694	2	1	1	2	6
OG0001695	3	1	1	1	6
OG0001696	1	2	2	1	6
OG0001697	3	1	1	1	6
OG0001698	3	1	1	1	6
OG0001699	1	2	0	3	6
OG0001700	1	2	1	2	6
OG0001701	2	1	2	1	6
OG0001702	2	2	1	1	6
OG0001703	1	1	2	2	6
OG0001704	2	1	1	2	6
OG0001705	2	1	1	2	6
OG0001706	1	2	1	2	6
OG0001707	3	1	1	1	6
OG0001708	1	0	2	3	6
OG0001709	3	1	1	1	6
OG0001710	1	1	2	2	6
OG0001711	1	1	2	2	6
OG0001712	1	0	1	4	6
OG0001713	1	2	2	1	6
OG0001714	2	1	1	2	6
OG0001715	2	1	1	2	6
OG0001716	1	2	1	2	6
OG0001717	1	1	4	0	6
OG0001718	2	1	1	2	6
OG0001719	1	3	1	1	6
OG0001720	1	1	2	2	6
OG0001721	2	1	1	2	6
OG0001722	2	1	1	2	6
OG0001723	2	1	2	1	6
OG0001724	3	1	0	2	6
OG0001725	3	1	1	1	6
OG0001726	1	1	1	3	6
OG0001727	1	1	1	3	6
OG0001728	1	1	3	1	6
OG0001729	1	1	1	3	6
OG0001730	1	1	1	3	6
OG0001731	1	1	2	2	6
OG0001732	1	2	2	1	6
OG0001733	1	1	2	2	6
OG0001734	1	1	1	3	6
OG0001735	1	1	2	2	6
OG0001736	1	2	1	2	6
OG0001737	1	1	2	2	6
OG0001738	1	1	1	3	6
OG0001739	1	1	2	2	6
OG0001740	1	1	2	2	6
OG0001741	1	1	2	2	6
OG0001742	1	1	2	2	6
OG0001743	1	1	2	2	6
OG0001744	1	1	2	2	6
OG0001745	1	1	2	2	6
OG0001746	1	1	2	2	6
OG0001747	1	1	2	2	6
OG0001748	1	2	2	1	6
OG0001749	1	2	1	2	6
OG0001750	1	1	2	2	6
OG0001751	1	1	2	2	6
OG0001752	1	1	2	2	6
OG0001753	1	1	3	1	6
OG0001754	1	3	1	1	6
OG0001755	1	1	1	3	6
OG0001756	1	1	1	3	6
OG0001757	1	3	1	1	6
OG0001758	1	1	1	3	6
OG0001759	1	1	2	2	6
OG0001760	1	1	1	3	6
OG0001761	1	1	2	2	6
OG0001762	0	1	3	2	6
OG0001763	0	1	1	4	6
OG0001764	0	1	2	3	6
OG0001765	0	2	1	3	6
OG0001766	0	1	4	1	6
OG0001767	0	6	0	0	6
OG0001768	0	2	1	3	6
OG0001769	0	1	1	4	6
OG0001770	0	2	3	1	6
OG0001771	0	2	2	2	6
OG0001772	0	6	0	0	6
OG0001773	0	6	0	0	6
OG0001774	0	4	1	1	6
OG0001775	0	1	2	3	6
OG0001776	0	2	2	2	6
OG0001777	0	1	1	4	6
OG0001778	0	1	3	2	6
OG0001779	0	1	2	3	6
OG0001780	0	1	4	1	6
OG0001781	0	1	2	3	6
OG0001782	0	1	2	3	6
OG0001783	0	1	3	2	6
OG0001784	0	2	0	4	6
OG0001785	0	3	1	2	6
OG0001786	0	1	2	3	6
OG0001787	0	2	1	3	6
OG0001788	0	1	2	3	6
OG0001789	0	1	4	1	6
OG0001790	0	1	3	2	6
OG0001791	0	2	2	2	6
OG0001792	0	2	2	2	6
OG0001793	0	3	2	1	6
OG0001794	0	1	4	1	6
OG0001795	0	1	3	2	6
OG0001796	0	1	3	2	6
OG0001797	0	2	2	2	6
OG0001798	0	1	2	3	6
OG0001799	0	1	3	2	6
OG0001800	0	3	2	1	6
OG0001801	0	1	3	2	6
OG0001802	0	1	2	3	6
OG0001803	0	1	3	2	6
OG0001804	0	1	2	3	6
OG0001805	0	1	2	3	6
OG0001806	0	1	4	1	6
OG0001807	0	1	3	2	6
OG0001808	0	2	2	2	6
OG0001809	0	1	3	2	6
OG0001810	0	1	5	0	6
OG0001811	0	1	3	2	6
OG0001812	0	1	3	2	6
OG0001813	0	2	2	2	6
OG0001814	0	1	3	2	6
OG0001815	0	1	2	3	6
OG0001816	0	2	1	3	6
OG0001817	0	2	0	4	6
OG0001818	0	2	2	2	6
OG0001819	0	4	1	1	6
OG0001820	0	1	2	3	6
OG0001821	0	1	3	2	6
OG0001822	0	1	4	1	6
OG0001823	0	1	3	2	6
OG0001824	0	2	2	2	6
OG0001825	0	2	2	2	6
OG0001826	0	1	3	2	6
OG0001827	0	1	2	3	6
OG0001828	0	0	5	1	6
OG0001829	0	0	4	2	6
OG0001830	0	0	4	2	6
OG0001831	0	0	1	5	6
OG0001832	0	0	1	5	6
OG0001833	0	0	6	0	6
OG0001834	0	0	2	4	6
OG0001835	0	0	2	4	6
OG0001836	2	1	1	1	5
OG0001837	2	2	0	1	5
OG0001838	2	1	1	1	5
OG0001839	1	2	2	0	5
OG0001840	2	1	1	1	5
OG0001841	1	1	2	1	5
OG0001842	5	0	0	0	5
OG0001843	1	1	1	2	5
OG0001844	1	1	2	1	5
OG0001845	2	1	1	1	5
OG0001846	2	1	1	1	5
OG0001847	2	1	1	1	5
OG0001848	1	1	2	1	5
OG0001849	2	1	1	1	5
OG0001850	2	1	1	1	5
OG0001851	1	2	1	1	5
OG0001852	2	1	1	1	5
OG0001853	1	2	1	1	5
OG0001854	1	1	2	1	5
OG0001855	2	1	1	1	5
OG0001856	2	1	1	1	5
OG0001857	3	2	0	0	5
OG0001858	2	1	0	2	5
OG0001859	1	1	1	2	5
OG0001860	1	1	1	2	5
OG0001861	2	1	1	1	5
OG0001862	2	1	1	1	5
OG0001863	1	1	1	2	5
OG0001864	5	0	0	0	5
OG0001865	5	0	0	0	5
OG0001866	2	1	1	1	5
OG0001867	2	1	1	1	5
OG0001868	1	2	1	1	5
OG0001869	2	1	1	1	5
OG0001870	1	1	2	1	5
OG0001871	2	1	1	1	5
OG0001872	3	1	1	0	5
OG0001873	2	1	1	1	5
OG0001874	2	1	1	1	5
OG0001875	1	1	1	2	5
OG0001876	1	2	1	1	5
OG0001877	2	1	1	1	5
OG0001878	2	1	1	1	5
OG0001879	1	2	1	1	5
OG0001880	2	1	1	1	5
OG0001881	1	1	3	0	5
OG0001882	1	1	2	1	5
OG0001883	3	1	0	1	5
OG0001884	2	1	1	1	5
OG0001885	1	1	2	1	5
OG0001886	1	1	1	2	5
OG0001887	1	1	2	1	5
OG0001888	3	0	1	1	5
OG0001889	1	1	2	1	5
OG0001890	1	1	1	2	5
OG0001891	1	2	1	1	5
OG0001892	2	1	1	1	5
OG0001893	1	1	2	1	5
OG0001894	1	1	2	1	5
OG0001895	1	1	2	1	5
OG0001896	3	1	0	1	5
OG0001897	1	1	1	2	5
OG0001898	1	1	1	2	5
OG0001899	1	1	2	1	5
OG0001900	1	1	2	1	5
OG0001901	1	1	1	2	5
OG0001902	1	0	2	2	5
OG0001903	1	1	1	2	5
OG0001904	1	1	2	1	5
OG0001905	3	1	0	1	5
OG0001906	1	1	1	2	5
OG0001907	2	1	1	1	5
OG0001908	1	1	2	1	5
OG0001909	1	1	1	2	5
OG0001910	1	2	1	1	5
OG0001911	1	1	2	1	5
OG0001912	2	1	1	1	5
OG0001913	1	1	2	1	5
OG0001914	2	1	2	0	5
OG0001915	1	1	1	2	5
OG0001916	2	1	1	1	5
OG0001917	3	1	0	1	5
OG0001918	1	1	1	2	5
OG0001919	2	1	1	1	5
OG0001920	1	2	1	1	5
OG0001921	1	1	1	2	5
OG0001922	1	1	1	2	5
OG0001923	1	2	1	1	5
OG0001924	1	1	2	1	5
OG0001925	1	1	2	1	5
OG0001926	2	1	1	1	5
OG0001927	2	1	1	1	5
OG0001928	1	1	1	2	5
OG0001929	2	1	1	1	5
OG0001930	4	1	0	0	5
OG0001931	1	1	1	2	5
OG0001932	3	1	0	1	5
OG0001933	4	1	0	0	5
OG0001934	1	1	1	2	5
OG0001935	1	1	1	2	5
OG0001936	2	1	1	1	5
OG0001937	3	1	1	0	5
OG0001938	1	1	1	2	5
OG0001939	2	1	1	1	5
OG0001940	1	2	1	1	5
OG0001941	1	2	2	0	5
OG0001942	2	1	1	1	5
OG0001943	2	1	1	1	5
OG0001944	2	1	1	1	5
OG0001945	1	1	1	2	5
OG0001946	1	2	1	1	5
OG0001947	3	1	0	1	5
OG0001948	2	1	1	1	5
OG0001949	1	1	1	2	5
OG0001950	2	1	1	1	5
OG0001951	1	1	2	1	5
OG0001952	1	1	2	1	5
OG0001953	1	1	1	2	5
OG0001954	2	1	1	1	5
OG0001955	1	1	2	1	5
OG0001956	1	1	1	2	5
OG0001957	4	1	0	0	5
OG0001958	1	1	2	1	5
OG0001959	1	1	1	2	5
OG0001960	2	2	0	1	5
OG0001961	3	1	1	0	5
OG0001962	2	1	1	1	5
OG0001963	3	1	0	1	5
OG0001964	1	1	2	1	5
OG0001965	2	1	0	2	5
OG0001966	1	2	1	1	5
OG0001967	2	1	1	1	5
OG0001968	2	1	1	1	5
OG0001969	2	2	1	0	5
OG0001970	1	1	1	2	5
OG0001971	2	1	1	1	5
OG0001972	1	1	1	2	5
OG0001973	2	1	1	1	5
OG0001974	2	1	1	1	5
OG0001975	1	1	1	2	5
OG0001976	1	1	1	2	5
OG0001977	2	1	1	1	5
OG0001978	2	1	1	1	5
OG0001979	1	1	1	2	5
OG0001980	1	1	1	2	5
OG0001981	2	1	1	1	5
OG0001982	2	1	1	1	5
OG0001983	2	1	1	1	5
OG0001984	1	1	2	1	5
OG0001985	2	1	1	1	5
OG0001986	1	1	1	2	5
OG0001987	2	1	1	1	5
OG0001988	2	1	1	1	5
OG0001989	2	1	1	1	5
OG0001990	1	1	2	1	5
OG0001991	2	1	1	1	5
OG0001992	1	2	2	0	5
OG0001993	1	1	1	2	5
OG0001994	1	1	1	2	5
OG0001995	1	1	2	1	5
OG0001996	1	1	1	2	5
OG0001997	2	1	1	1	5
OG0001998	1	1	1	2	5
OG0001999	1	1	1	2	5
OG0002000	2	1	1	1	5
OG0002001	2	1	1	1	5
OG0002002	1	1	1	2	5
OG0002003	1	1	2	1	5
OG0002004	2	1	1	1	5
OG0002005	2	1	1	1	5
OG0002006	2	1	1	1	5
OG0002007	2	1	1	1	5
OG0002008	2	0	2	1	5
OG0002009	1	1	1	2	5
OG0002010	3	1	1	0	5
OG0002011	1	1	2	1	5
OG0002012	2	1	1	1	5
OG0002013	3	1	1	0	5
OG0002014	2	1	1	1	5
OG0002015	2	1	1	1	5
OG0002016	3	0	1	1	5
OG0002017	2	1	1	1	5
OG0002018	4	1	0	0	5
OG0002019	2	1	1	1	5
OG0002020	3	1	0	1	5
OG0002021	2	1	1	1	5
OG0002022	2	1	1	1	5
OG0002023	2	1	1	1	5
OG0002024	1	1	1	2	5
OG0002025	2	1	1	1	5
OG0002026	1	1	2	1	5
OG0002027	1	2	1	1	5
OG0002028	2	1	1	1	5
OG0002029	2	1	1	1	5
OG0002030	2	1	1	1	5
OG0002031	3	1	1	0	5
OG0002032	2	1	1	1	5
OG0002033	2	1	1	1	5
OG0002034	1	2	1	1	5
OG0002035	1	1	1	2	5
OG0002036	1	1	1	2	5
OG0002037	2	1	1	1	5
OG0002038	2	1	2	0	5
OG0002039	2	1	1	1	5
OG0002040	1	1	2	1	5
OG0002041	1	1	2	1	5
OG0002042	1	1	1	2	5
OG0002043	1	1	2	1	5
OG0002044	1	1	2	1	5
OG0002045	2	1	1	1	5
OG0002046	2	1	1	1	5
OG0002047	2	1	1	1	5
OG0002048	1	1	1	2	5
OG0002049	1	1	1	2	5
OG0002050	1	1	2	1	5
OG0002051	2	1	1	1	5
OG0002052	1	1	1	2	5
OG0002053	1	1	2	1	5
OG0002054	1	1	1	2	5
OG0002055	2	1	1	1	5
OG0002056	2	1	1	1	5
OG0002057	1	1	3	0	5
OG0002058	1	1	1	2	5
OG0002059	1	1	1	2	5
OG0002060	1	1	2	1	5
OG0002061	1	1	1	2	5
OG0002062	2	2	1	0	5
OG0002063	2	1	1	1	5
OG0002064	2	1	1	1	5
OG0002065	2	1	1	1	5
OG0002066	1	2	2	0	5
OG0002067	1	0	1	3	5
OG0002068	2	1	1	1	5
OG0002069	1	1	2	1	5
OG0002070	2	1	1	1	5
OG0002071	1	1	1	2	5
OG0002072	3	1	0	1	5
OG0002073	2	1	2	0	5
OG0002074	2	1	1	1	5
OG0002075	2	1	1	1	5
OG0002076	3	1	1	0	5
OG0002077	2	1	1	1	5
OG0002078	1	1	1	2	5
OG0002079	2	1	1	1	5
OG0002080	2	1	1	1	5
OG0002081	2	0	2	1	5
OG0002082	2	1	1	1	5
OG0002083	2	1	1	1	5
OG0002084	2	1	0	2	5
OG0002085	1	1	1	2	5
OG0002086	1	1	1	2	5
OG0002087	1	2	1	1	5
OG0002088	2	0	2	1	5
OG0002089	3	1	1	0	5
OG0002090	2	1	1	1	5
OG0002091	2	1	1	1	5
OG0002092	2	1	1	1	5
OG0002093	2	1	1	1	5
OG0002094	2	1	1	1	5
OG0002095	1	1	1	2	5
OG0002096	2	1	1	1	5
OG0002097	1	1	2	1	5
OG0002098	2	1	1	1	5
OG0002099	1	1	2	1	5
OG0002100	1	1	2	1	5
OG0002101	3	1	1	0	5
OG0002102	2	1	1	1	5
OG0002103	2	1	0	2	5
OG0002104	1	1	1	2	5
OG0002105	1	1	1	2	5
OG0002106	2	1	1	1	5
OG0002107	1	1	1	2	5
OG0002108	2	1	1	1	5
OG0002109	2	1	1	1	5
OG0002110	2	1	1	1	5
OG0002111	2	1	0	2	5
OG0002112	1	1	1	2	5
OG0002113	1	1	1	2	5
OG0002114	2	1	1	1	5
OG0002115	2	1	1	1	5
OG0002116	1	1	1	2	5
OG0002117	1	1	1	2	5
OG0002118	3	1	1	0	5
OG0002119	1	1	1	2	5
OG0002120	1	2	1	1	5
OG0002121	1	2	1	1	5
OG0002122	3	1	0	1	5
OG0002123	1	1	1	2	5
OG0002124	1	2	0	2	5
OG0002125	1	1	2	1	5
OG0002126	3	1	0	1	5
OG0002127	1	1	2	1	5
OG0002128	2	1	1	1	5
OG0002129	3	1	0	1	5
OG0002130	1	1	1	2	5
OG0002131	2	1	1	1	5
OG0002132	2	1	0	2	5
OG0002133	2	1	2	0	5
OG0002134	1	1	1	2	5
OG0002135	1	1	1	2	5
OG0002136	1	1	1	2	5
OG0002137	3	1	1	0	5
OG0002138	2	0	2	1	5
OG0002139	2	0	1	2	5
OG0002140	1	1	1	2	5
OG0002141	2	2	0	1	5
OG0002142	1	1	1	2	5
OG0002143	2	1	2	0	5
OG0002144	3	1	1	0	5
OG0002145	1	1	1	2	5
OG0002146	2	1	1	1	5
OG0002147	1	3	1	0	5
OG0002148	2	1	1	1	5
OG0002149	1	1	1	2	5
OG0002150	2	1	1	1	5
OG0002151	1	1	1	2	5
OG0002152	1	1	2	1	5
OG0002153	1	1	2	1	5
OG0002154	1	1	2	1	5
OG0002155	1	1	2	1	5
OG0002156	2	1	1	1	5
OG0002157	1	1	2	1	5
OG0002158	2	1	1	1	5
OG0002159	2	1	1	1	5
OG0002160	2	1	1	1	5
OG0002161	2	1	1	1	5
OG0002162	2	1	1	1	5
OG0002163	2	1	1	1	5
OG0002164	1	1	1	2	5
OG0002165	2	1	0	2	5
OG0002166	2	1	1	1	5
OG0002167	2	1	1	1	5
OG0002168	1	2	1	1	5
OG0002169	1	1	2	1	5
OG0002170	2	1	0	2	5
OG0002171	1	1	1	2	5
OG0002172	2	1	1	1	5
OG0002173	2	1	1	1	5
OG0002174	2	1	1	1	5
OG0002175	1	1	0	3	5
OG0002176	2	1	1	1	5
OG0002177	1	1	1	2	5
OG0002178	2	1	1	1	5
OG0002179	2	1	1	1	5
OG0002180	1	1	2	1	5
OG0002181	1	1	1	2	5
OG0002182	2	1	1	1	5
OG0002183	1	1	2	1	5
OG0002184	2	0	1	2	5
OG0002185	1	1	2	1	5
OG0002186	2	1	1	1	5
OG0002187	2	1	1	1	5
OG0002188	2	1	1	1	5
OG0002189	2	1	1	1	5
OG0002190	1	1	2	1	5
OG0002191	3	1	1	0	5
OG0002192	1	2	0	2	5
OG0002193	2	1	1	1	5
OG0002194	1	1	2	1	5
OG0002195	1	1	2	1	5
OG0002196	1	1	0	3	5
OG0002197	2	1	1	1	5
OG0002198	2	1	1	1	5
OG0002199	2	1	1	1	5
OG0002200	2	1	1	1	5
OG0002201	1	1	1	2	5
OG0002202	2	1	2	0	5
OG0002203	2	0	2	1	5
OG0002204	2	1	1	1	5
OG0002205	1	1	1	2	5
OG0002206	2	1	1	1	5
OG0002207	1	1	2	1	5
OG0002208	3	1	0	1	5
OG0002209	2	1	1	1	5
OG0002210	1	1	2	1	5
OG0002211	2	1	1	1	5
OG0002212	2	1	2	0	5
OG0002213	2	1	1	1	5
OG0002214	2	1	1	1	5
OG0002215	3	1	1	0	5
OG0002216	1	1	2	1	5
OG0002217	1	1	1	2	5
OG0002218	2	1	1	1	5
OG0002219	5	0	0	0	5
OG0002220	2	1	1	1	5
OG0002221	3	1	1	0	5
OG0002222	3	1	0	1	5
OG0002223	2	0	2	1	5
OG0002224	2	1	1	1	5
OG0002225	1	1	1	2	5
OG0002226	2	1	1	1	5
OG0002227	2	0	1	2	5
OG0002228	2	1	1	1	5
OG0002229	2	2	1	0	5
OG0002230	2	1	1	1	5
OG0002231	3	1	0	1	5
OG0002232	2	1	2	0	5
OG0002233	3	1	1	0	5
OG0002234	2	1	1	1	5
OG0002235	2	1	1	1	5
OG0002236	1	0	2	2	5
OG0002237	1	1	1	2	5
OG0002238	1	1	1	2	5
OG0002239	2	1	1	1	5
OG0002240	5	0	0	0	5
OG0002241	1	1	1	2	5
OG0002242	2	1	1	1	5
OG0002243	2	1	1	1	5
OG0002244	2	1	1	1	5
OG0002245	1	1	2	1	5
OG0002246	3	1	1	0	5
OG0002247	1	1	2	1	5
OG0002248	1	1	1	2	5
OG0002249	1	1	1	2	5
OG0002250	2	1	1	1	5
OG0002251	2	1	1	1	5
OG0002252	1	1	2	1	5
OG0002253	1	1	1	2	5
OG0002254	2	1	1	1	5
OG0002255	2	1	1	1	5
OG0002256	1	1	2	1	5
OG0002257	1	1	3	0	5
OG0002258	1	1	2	1	5
OG0002259	2	1	1	1	5
OG0002260	3	1	1	0	5
OG0002261	2	1	0	2	5
OG0002262	3	1	1	0	5
OG0002263	2	1	1	1	5
OG0002264	2	1	1	1	5
OG0002265	2	1	1	1	5
OG0002266	2	1	1	1	5
OG0002267	1	1	1	2	5
OG0002268	1	1	1	2	5
OG0002269	1	1	3	0	5
OG0002270	3	1	0	1	5
OG0002271	5	0	0	0	5
OG0002272	2	1	1	1	5
OG0002273	2	1	1	1	5
OG0002274	3	1	1	0	5
OG0002275	3	0	1	1	5
OG0002276	1	1	1	2	5
OG0002277	2	1	0	2	5
OG0002278	2	1	1	1	5
OG0002279	1	1	2	1	5
OG0002280	1	0	2	2	5
OG0002281	1	2	1	1	5
OG0002282	1	2	0	2	5
OG0002283	2	1	1	1	5
OG0002284	1	1	1	2	5
OG0002285	2	1	1	1	5
OG0002286	2	1	1	1	5
OG0002287	2	0	2	1	5
OG0002288	2	1	1	1	5
OG0002289	1	1	2	1	5
OG0002290	2	1	1	1	5
OG0002291	2	1	1	1	5
OG0002292	2	1	1	1	5
OG0002293	1	1	1	2	5
OG0002294	2	1	1	1	5
OG0002295	1	1	2	1	5
OG0002296	2	1	1	1	5
OG0002297	2	1	1	1	5
OG0002298	2	1	0	2	5
OG0002299	1	1	1	2	5
OG0002300	2	1	2	0	5
OG0002301	1	1	2	1	5
OG0002302	2	0	0	3	5
OG0002303	2	1	0	2	5
OG0002304	3	0	1	1	5
OG0002305	2	1	1	1	5
OG0002306	2	1	1	1	5
OG0002307	2	1	1	1	5
OG0002308	1	1	1	2	5
OG0002309	2	1	1	1	5
OG0002310	2	1	1	1	5
OG0002311	3	0	1	1	5
OG0002312	2	1	1	1	5
OG0002313	2	1	1	1	5
OG0002314	2	1	1	1	5
OG0002315	1	1	2	1	5
OG0002316	1	1	2	1	5
OG0002317	2	1	1	1	5
OG0002318	1	1	3	0	5
OG0002319	2	1	1	1	5
OG0002320	3	0	1	1	5
OG0002321	1	1	1	2	5
OG0002322	1	1	1	2	5
OG0002323	2	1	1	1	5
OG0002324	1	1	1	2	5
OG0002325	2	1	1	1	5
OG0002326	2	1	0	2	5
OG0002327	1	1	1	2	5
OG0002328	2	1	1	1	5
OG0002329	3	1	0	1	5
OG0002330	1	2	1	1	5
OG0002331	2	1	1	1	5
OG0002332	2	1	1	1	5
OG0002333	1	1	1	2	5
OG0002334	2	1	0	2	5
OG0002335	2	1	1	1	5
OG0002336	2	1	1	1	5
OG0002337	1	1	1	2	5
OG0002338	2	1	1	1	5
OG0002339	1	1	1	2	5
OG0002340	1	1	1	2	5
OG0002341	1	1	2	1	5
OG0002342	2	1	2	0	5
OG0002343	3	1	0	1	5
OG0002344	4	0	0	1	5
OG0002345	1	1	2	1	5
OG0002346	2	1	1	1	5
OG0002347	3	1	1	0	5
OG0002348	1	1	1	2	5
OG0002349	1	1	2	1	5
OG0002350	2	1	1	1	5
OG0002351	2	1	1	1	5
OG0002352	1	1	1	2	5
OG0002353	2	1	1	1	5
OG0002354	1	1	2	1	5
OG0002355	1	1	1	2	5
OG0002356	1	1	1	2	5
OG0002357	2	0	2	1	5
OG0002358	1	1	1	2	5
OG0002359	1	1	2	1	5
OG0002360	2	1	0	2	5
OG0002361	1	2	1	1	5
OG0002362	1	1	1	2	5
OG0002363	2	1	1	1	5
OG0002364	1	2	1	1	5
OG0002365	1	1	2	1	5
OG0002366	3	1	1	0	5
OG0002367	1	1	1	2	5
OG0002368	1	1	1	2	5
OG0002369	2	0	1	2	5
OG0002370	2	1	2	0	5
OG0002371	1	1	1	2	5
OG0002372	2	1	1	1	5
OG0002373	1	1	2	1	5
OG0002374	1	1	1	2	5
OG0002375	1	1	2	1	5
OG0002376	1	1	2	1	5
OG0002377	2	1	1	1	5
OG0002378	2	0	2	1	5
OG0002379	2	1	1	1	5
OG0002380	2	1	1	1	5
OG0002381	1	1	1	2	5
OG0002382	1	1	1	2	5
OG0002383	2	1	1	1	5
OG0002384	1	0	0	4	5
OG0002385	1	1	0	3	5
OG0002386	1	1	2	1	5
OG0002387	2	1	1	1	5
OG0002388	2	1	1	1	5
OG0002389	1	1	2	1	5
OG0002390	1	1	1	2	5
OG0002391	2	1	1	1	5
OG0002392	1	1	1	2	5
OG0002393	2	1	1	1	5
OG0002394	1	1	1	2	5
OG0002395	1	1	2	1	5
OG0002396	1	1	1	2	5
OG0002397	2	1	1	1	5
OG0002398	1	1	1	2	5
OG0002399	2	1	1	1	5
OG0002400	1	0	1	3	5
OG0002401	2	1	1	1	5
OG0002402	2	1	1	1	5
OG0002403	2	1	0	2	5
OG0002404	1	1	3	0	5
OG0002405	2	1	1	1	5
OG0002406	2	1	1	1	5
OG0002407	1	1	2	1	5
OG0002408	5	0	0	0	5
OG0002409	2	1	1	1	5
OG0002410	1	1	2	1	5
OG0002411	2	1	1	1	5
OG0002412	2	1	1	1	5
OG0002413	2	1	1	1	5
OG0002414	1	2	1	1	5
OG0002415	2	1	1	1	5
OG0002416	1	1	1	2	5
OG0002417	2	1	1	1	5
OG0002418	2	1	0	2	5
OG0002419	3	0	1	1	5
OG0002420	1	1	1	2	5
OG0002421	1	1	0	3	5
OG0002422	1	1	1	2	5
OG0002423	2	1	1	1	5
OG0002424	1	1	1	2	5
OG0002425	1	1	2	1	5
OG0002426	1	2	1	1	5
OG0002427	2	1	1	1	5
OG0002428	1	1	2	1	5
OG0002429	2	0	0	3	5
OG0002430	1	1	2	1	5
OG0002431	1	1	1	2	5
OG0002432	1	1	2	1	5
OG0002433	2	1	1	1	5
OG0002434	2	1	0	2	5
OG0002435	1	1	2	1	5
OG0002436	2	1	1	1	5
OG0002437	2	1	1	1	5
OG0002438	1	1	2	1	5
OG0002439	1	1	1	2	5
OG0002440	1	1	1	2	5
OG0002441	1	1	1	2	5
OG0002442	2	1	1	1	5
OG0002443	1	1	2	1	5
OG0002444	2	1	1	1	5
OG0002445	1	1	1	2	5
OG0002446	1	2	1	1	5
OG0002447	1	1	2	1	5
OG0002448	1	1	1	2	5
OG0002449	2	1	1	1	5
OG0002450	2	1	1	1	5
OG0002451	3	1	1	0	5
OG0002452	2	1	1	1	5
OG0002453	1	1	1	2	5
OG0002454	1	1	1	2	5
OG0002455	2	1	1	1	5
OG0002456	3	1	0	1	5
OG0002457	3	1	1	0	5
OG0002458	1	0	1	3	5
OG0002459	1	1	1	2	5
OG0002460	3	1	1	0	5
OG0002461	1	1	2	1	5
OG0002462	1	1	2	1	5
OG0002463	2	1	1	1	5
OG0002464	1	1	1	2	5
OG0002465	2	1	1	1	5
OG0002466	5	0	0	0	5
OG0002467	2	1	0	2	5
OG0002468	1	2	1	1	5
OG0002469	1	1	2	1	5
OG0002470	1	1	2	1	5
OG0002471	1	2	2	0	5
OG0002472	2	1	1	1	5
OG0002473	2	0	1	2	5
OG0002474	1	1	1	2	5
OG0002475	2	1	1	1	5
OG0002476	2	1	2	0	5
OG0002477	2	1	1	1	5
OG0002478	1	1	1	2	5
OG0002479	1	1	2	1	5
OG0002480	2	2	1	0	5
OG0002481	5	0	0	0	5
OG0002482	2	1	1	1	5
OG0002483	2	1	1	1	5
OG0002484	1	1	2	1	5
OG0002485	2	1	1	1	5
OG0002486	1	1	2	1	5
OG0002487	1	2	1	1	5
OG0002488	3	1	1	0	5
OG0002489	1	0	2	2	5
OG0002490	1	1	2	1	5
OG0002491	1	3	1	0	5
OG0002492	1	2	2	0	5
OG0002493	4	0	1	0	5
OG0002494	2	1	1	1	5
OG0002495	2	1	0	2	5
OG0002496	1	1	2	1	5
OG0002497	1	0	1	3	5
OG0002498	2	1	2	0	5
OG0002499	2	1	1	1	5
OG0002500	3	1	1	0	5
OG0002501	3	1	1	0	5
OG0002502	2	1	1	1	5
OG0002503	2	1	1	1	5
OG0002504	1	1	1	2	5
OG0002505	2	1	1	1	5
OG0002506	2	1	0	2	5
OG0002507	1	1	2	1	5
OG0002508	2	1	1	1	5
OG0002509	1	1	2	1	5
OG0002510	2	1	1	1	5
OG0002511	2	1	1	1	5
OG0002512	2	1	1	1	5
OG0002513	1	1	1	2	5
OG0002514	1	1	1	2	5
OG0002515	1	1	1	2	5
OG0002516	3	1	0	1	5
OG0002517	2	1	1	1	5
OG0002518	2	1	1	1	5
OG0002519	1	1	2	1	5
OG0002520	2	1	1	1	5
OG0002521	1	1	1	2	5
OG0002522	1	2	1	1	5
OG0002523	2	1	0	2	5
OG0002524	2	1	1	1	5
OG0002525	2	1	1	1	5
OG0002526	1	2	1	1	5
OG0002527	1	2	0	2	5
OG0002528	1	1	1	2	5
OG0002529	1	1	2	1	5
OG0002530	1	1	2	1	5
OG0002531	1	1	2	1	5
OG0002532	1	2	1	1	5
OG0002533	1	1	2	1	5
OG0002534	1	2	1	1	5
OG0002535	3	1	0	1	5
OG0002536	1	1	1	2	5
OG0002537	1	1	0	3	5
OG0002538	1	2	0	2	5
OG0002539	1	2	2	0	5
OG0002540	1	1	1	2	5
OG0002541	1	1	1	2	5
OG0002542	1	1	1	2	5
OG0002543	1	1	2	1	5
OG0002544	1	1	1	2	5
OG0002545	2	1	1	1	5
OG0002546	1	1	2	1	5
OG0002547	1	1	1	2	5
OG0002548	1	1	2	1	5
OG0002549	1	1	2	1	5
OG0002550	2	1	1	1	5
OG0002551	1	1	2	1	5
OG0002552	3	1	0	1	5
OG0002553	1	1	1	2	5
OG0002554	1	1	2	1	5
OG0002555	1	1	1	2	5
OG0002556	2	1	1	1	5
OG0002557	1	2	2	0	5
OG0002558	2	0	2	1	5
OG0002559	1	1	1	2	5
OG0002560	1	1	2	1	5
OG0002561	2	1	2	0	5
OG0002562	2	1	1	1	5
OG0002563	3	1	1	0	5
OG0002564	2	1	1	1	5
OG0002565	1	1	2	1	5
OG0002566	2	1	1	1	5
OG0002567	2	1	2	0	5
OG0002568	2	0	2	1	5
OG0002569	2	1	1	1	5
OG0002570	1	1	2	1	5
OG0002571	3	1	1	0	5
OG0002572	2	1	1	1	5
OG0002573	2	2	0	1	5
OG0002574	3	1	0	1	5
OG0002575	1	1	1	2	5
OG0002576	1	1	1	2	5
OG0002577	2	1	1	1	5
OG0002578	4	1	0	0	5
OG0002579	2	0	1	2	5
OG0002580	1	1	2	1	5
OG0002581	2	1	1	1	5
OG0002582	1	2	1	1	5
OG0002583	1	1	1	2	5
OG0002584	1	2	1	1	5
OG0002585	1	1	2	1	5
OG0002586	1	1	1	2	5
OG0002587	1	1	1	2	5
OG0002588	1	1	2	1	5
OG0002589	1	1	2	1	5
OG0002590	1	1	2	1	5
OG0002591	1	1	2	1	5
OG0002592	2	1	1	1	5
OG0002593	5	0	0	0	5
OG0002594	2	1	1	1	5
OG0002595	2	0	0	3	5
OG0002596	2	0	2	1	5
OG0002597	1	1	2	1	5
OG0002598	1	1	1	2	5
OG0002599	2	1	1	1	5
OG0002600	1	1	1	2	5
OG0002601	2	1	1	1	5
OG0002602	1	1	2	1	5
OG0002603	2	1	2	0	5
OG0002604	2	1	2	0	5
OG0002605	2	1	1	1	5
OG0002606	1	1	1	2	5
OG0002607	1	1	1	2	5
OG0002608	2	1	1	1	5
OG0002609	1	2	1	1	5
OG0002610	2	1	1	1	5
OG0002611	2	1	1	1	5
OG0002612	1	1	1	2	5
OG0002613	2	1	1	1	5
OG0002614	2	1	1	1	5
OG0002615	1	1	2	1	5
OG0002616	2	1	1	1	5
OG0002617	2	1	1	1	5
OG0002618	1	1	0	3	5
OG0002619	1	1	2	1	5
OG0002620	1	2	1	1	5
OG0002621	1	1	2	1	5
OG0002622	1	1	2	1	5
OG0002623	1	1	2	1	5
OG0002624	1	2	1	1	5
OG0002625	1	1	1	2	5
OG0002626	2	1	1	1	5
OG0002627	2	1	1	1	5
OG0002628	1	1	1	2	5
OG0002629	1	2	1	1	5
OG0002630	2	1	2	0	5
OG0002631	2	1	1	1	5
OG0002632	2	1	1	1	5
OG0002633	3	1	1	0	5
OG0002634	1	1	2	1	5
OG0002635	1	1	1	2	5
OG0002636	1	1	2	1	5
OG0002637	1	3	1	0	5
OG0002638	2	1	1	1	5
OG0002639	1	2	1	1	5
OG0002640	1	2	1	1	5
OG0002641	1	2	2	0	5
OG0002642	1	1	2	1	5
OG0002643	1	1	1	2	5
OG0002644	1	1	1	2	5
OG0002645	1	2	1	1	5
OG0002646	1	1	2	1	5
OG0002647	1	1	1	2	5
OG0002648	1	1	1	2	5
OG0002649	1	1	1	2	5
OG0002650	1	1	1	2	5
OG0002651	1	1	2	1	5
OG0002652	1	1	2	1	5
OG0002653	1	1	2	1	5
OG0002654	1	1	1	2	5
OG0002655	1	1	2	1	5
OG0002656	1	1	1	2	5
OG0002657	1	1	1	2	5
OG0002658	1	1	1	2	5
OG0002659	1	1	1	2	5
OG0002660	1	1	1	2	5
OG0002661	1	1	2	1	5
OG0002662	1	2	1	1	5
OG0002663	1	1	2	1	5
OG0002664	1	1	2	1	5
OG0002665	1	1	2	1	5
OG0002666	1	1	2	1	5
OG0002667	1	1	1	2	5
OG0002668	1	2	1	1	5
OG0002669	1	1	2	1	5
OG0002670	1	1	1	2	5
OG0002671	1	1	1	2	5
OG0002672	1	1	1	2	5
OG0002673	1	1	1	2	5
OG0002674	1	1	2	1	5
OG0002675	1	1	2	1	5
OG0002676	1	1	1	2	5
OG0002677	1	1	1	2	5
OG0002678	1	1	1	2	5
OG0002679	1	2	0	2	5
OG0002680	1	1	1	2	5
OG0002681	1	2	1	1	5
OG0002682	1	1	2	1	5
OG0002683	1	1	1	2	5
OG0002684	1	1	1	2	5
OG0002685	1	1	1	2	5
OG0002686	1	1	1	2	5
OG0002687	1	1	2	1	5
OG0002688	1	1	2	1	5
OG0002689	1	1	2	1	5
OG0002690	1	1	1	2	5
OG0002691	1	1	2	1	5
OG0002692	1	1	2	1	5
OG0002693	1	1	1	2	5
OG0002694	1	2	1	1	5
OG0002695	1	1	1	2	5
OG0002696	1	1	2	1	5
OG0002697	1	0	1	3	5
OG0002698	1	1	2	1	5
OG0002699	1	1	2	1	5
OG0002700	1	2	1	1	5
OG0002701	1	1	2	1	5
OG0002702	1	1	1	2	5
OG0002703	1	1	2	1	5
OG0002704	1	2	1	1	5
OG0002705	1	1	2	1	5
OG0002706	1	1	2	1	5
OG0002707	1	2	1	1	5
OG0002708	1	1	1	2	5
OG0002709	1	2	1	1	5
OG0002710	1	1	2	1	5
OG0002711	1	1	1	2	5
OG0002712	1	1	2	1	5
OG0002713	1	1	1	2	5
OG0002714	1	1	2	1	5
OG0002715	1	2	1	1	5
OG0002716	1	1	1	2	5
OG0002717	1	1	2	1	5
OG0002718	1	1	2	1	5
OG0002719	1	2	1	1	5
OG0002720	1	2	1	1	5
OG0002721	1	2	1	1	5
OG0002722	1	1	1	2	5
OG0002723	1	1	1	2	5
OG0002724	1	1	1	2	5
OG0002725	1	1	1	2	5
OG0002726	1	1	2	1	5
OG0002727	1	1	2	1	5
OG0002728	1	2	2	0	5
OG0002729	1	1	2	1	5
OG0002730	1	2	1	1	5
OG0002731	1	1	2	1	5
OG0002732	1	1	1	2	5
OG0002733	1	1	2	1	5
OG0002734	1	2	1	1	5
OG0002735	1	2	1	1	5
OG0002736	1	1	2	1	5
OG0002737	1	1	2	1	5
OG0002738	1	1	1	2	5
OG0002739	1	1	0	3	5
OG0002740	1	2	1	1	5
OG0002741	1	1	2	1	5
OG0002742	1	1	2	1	5
OG0002743	1	1	1	2	5
OG0002744	1	1	2	1	5
OG0002745	1	1	2	1	5
OG0002746	1	1	2	1	5
OG0002747	1	1	2	1	5
OG0002748	1	1	2	1	5
OG0002749	1	1	2	1	5
OG0002750	1	1	1	2	5
OG0002751	1	1	2	1	5
OG0002752	1	1	1	2	5
OG0002753	0	1	1	3	5
OG0002754	0	3	1	1	5
OG0002755	0	1	1	3	5
OG0002756	0	1	1	3	5
OG0002757	0	1	1	3	5
OG0002758	0	2	1	2	5
OG0002759	0	4	0	1	5
OG0002760	0	1	2	2	5
OG0002761	0	4	1	0	5
OG0002762	0	1	3	1	5
OG0002763	0	3	1	1	5
OG0002764	0	1	2	2	5
OG0002765	0	2	2	1	5
OG0002766	0	2	1	2	5
OG0002767	0	2	1	2	5
OG0002768	0	1	3	1	5
OG0002769	0	5	0	0	5
OG0002770	0	1	2	2	5
OG0002771	0	2	1	2	5
OG0002772	0	1	1	3	5
OG0002773	0	2	2	1	5
OG0002774	0	1	1	3	5
OG0002775	0	2	2	1	5
OG0002776	0	5	0	0	5
OG0002777	0	1	2	2	5
OG0002778	0	5	0	0	5
OG0002779	0	2	1	2	5
OG0002780	0	1	2	2	5
OG0002781	0	1	3	1	5
OG0002782	0	1	3	1	5
OG0002783	0	5	0	0	5
OG0002784	0	5	0	0	5
OG0002785	0	1	2	2	5
OG0002786	0	1	1	3	5
OG0002787	0	1	1	3	5
OG0002788	0	1	2	2	5
OG0002789	0	1	2	2	5
OG0002790	0	3	1	1	5
OG0002791	0	1	3	1	5
OG0002792	0	1	2	2	5
OG0002793	0	1	2	2	5
OG0002794	0	2	2	1	5
OG0002795	0	1	1	3	5
OG0002796	0	3	1	1	5
OG0002797	0	2	2	1	5
OG0002798	0	1	1	3	5
OG0002799	0	3	1	1	5
OG0002800	0	4	1	0	5
OG0002801	0	1	1	3	5
OG0002802	0	1	1	3	5
OG0002803	0	4	1	0	5
OG0002804	0	2	1	2	5
OG0002805	0	1	2	2	5
OG0002806	0	1	2	2	5
OG0002807	0	1	2	2	5
OG0002808	0	5	0	0	5
OG0002809	0	2	2	1	5
OG0002810	0	5	0	0	5
OG0002811	0	1	2	2	5
OG0002812	0	2	1	2	5
OG0002813	0	1	2	2	5
OG0002814	0	1	1	3	5
OG0002815	0	1	1	3	5
OG0002816	0	2	3	0	5
OG0002817	0	3	1	1	5
OG0002818	0	1	3	1	5
OG0002819	0	3	1	1	5
OG0002820	0	1	1	3	5
OG0002821	0	1	3	1	5
OG0002822	0	1	3	1	5
OG0002823	0	1	0	4	5
OG0002824	0	1	1	3	5
OG0002825	0	1	2	2	5
OG0002826	0	1	2	2	5
OG0002827	0	1	1	3	5
OG0002828	0	1	3	1	5
OG0002829	0	3	1	1	5
OG0002830	0	1	2	2	5
OG0002831	0	1	3	1	5
OG0002832	0	1	1	3	5
OG0002833	0	3	1	1	5
OG0002834	0	1	2	2	5
OG0002835	0	3	1	1	5
OG0002836	0	2	1	2	5
OG0002837	0	1	1	3	5
OG0002838	0	5	0	0	5
OG0002839	0	2	2	1	5
OG0002840	0	3	1	1	5
OG0002841	0	2	1	2	5
OG0002842	0	1	2	2	5
OG0002843	0	1	1	3	5
OG0002844	0	2	2	1	5
OG0002845	0	1	2	2	5
OG0002846	0	1	2	2	5
OG0002847	0	1	2	2	5
OG0002848	0	1	1	3	5
OG0002849	0	1	3	1	5
OG0002850	0	1	2	2	5
OG0002851	0	1	2	2	5
OG0002852	0	1	3	1	5
OG0002853	0	1	2	2	5
OG0002854	0	1	3	1	5
OG0002855	0	1	2	2	5
OG0002856	0	1	1	3	5
OG0002857	0	2	1	2	5
OG0002858	0	1	1	3	5
OG0002859	0	1	2	2	5
OG0002860	0	3	1	1	5
OG0002861	0	1	0	4	5
OG0002862	0	1	3	1	5
OG0002863	0	3	1	1	5
OG0002864	0	1	2	2	5
OG0002865	0	1	1	3	5
OG0002866	0	2	1	2	5
OG0002867	0	2	2	1	5
OG0002868	0	1	2	2	5
OG0002869	0	1	2	2	5
OG0002870	0	1	2	2	5
OG0002871	0	1	1	3	5
OG0002872	0	1	3	1	5
OG0002873	0	1	1	3	5
OG0002874	0	1	1	3	5
OG0002875	0	2	0	3	5
OG0002876	0	1	1	3	5
OG0002877	0	1	3	1	5
OG0002878	0	2	2	1	5
OG0002879	0	1	2	2	5
OG0002880	0	1	1	3	5
OG0002881	0	1	2	2	5
OG0002882	0	1	4	0	5
OG0002883	0	1	2	2	5
OG0002884	0	1	2	2	5
OG0002885	0	1	2	2	5
OG0002886	0	1	2	2	5
OG0002887	0	3	1	1	5
OG0002888	0	1	1	3	5
OG0002889	0	1	2	2	5
OG0002890	0	1	2	2	5
OG0002891	0	2	2	1	5
OG0002892	0	1	3	1	5
OG0002893	0	1	2	2	5
OG0002894	0	1	2	2	5
OG0002895	0	1	1	3	5
OG0002896	0	1	3	1	5
OG0002897	0	1	2	2	5
OG0002898	0	1	2	2	5
OG0002899	0	1	1	3	5
OG0002900	0	1	2	2	5
OG0002901	0	1	2	2	5
OG0002902	0	1	2	2	5
OG0002903	0	4	1	0	5
OG0002904	0	1	1	3	5
OG0002905	0	1	2	2	5
OG0002906	0	1	2	2	5
OG0002907	0	1	1	3	5
OG0002908	0	1	0	4	5
OG0002909	0	1	2	2	5
OG0002910	0	0	2	3	5
OG0002911	0	0	1	4	5
OG0002912	0	0	5	0	5
OG0002913	0	0	3	2	5
OG0002914	0	0	2	3	5
OG0002915	0	0	4	1	5
OG0002916	0	0	2	3	5
OG0002917	0	0	1	4	5
OG0002918	0	0	1	4	5
OG0002919	0	0	0	5	5
OG0002920	0	0	0	5	5
OG0002921	0	0	0	5	5
OG0002922	0	0	0	5	5
OG0002923	0	0	0	5	5
OG0002924	0	0	0	5	5
OG0002925	0	0	0	5	5
OG0002926	1	1	1	1	4
OG0002927	1	1	1	1	4
OG0002928	2	1	1	0	4
OG0002929	1	1	1	1	4
OG0002930	1	1	1	1	4
OG0002931	1	1	1	1	4
OG0002932	1	1	1	1	4
OG0002933	1	1	1	1	4
OG0002934	2	1	1	0	4
OG0002935	1	1	0	2	4
OG0002936	1	1	1	1	4
OG0002937	1	1	1	1	4
OG0002938	2	1	0	1	4
OG0002939	1	1	1	1	4
OG0002940	1	1	1	1	4
OG0002941	1	1	1	1	4
OG0002942	1	1	1	1	4
OG0002943	2	0	1	1	4
OG0002944	1	1	1	1	4
OG0002945	1	1	1	1	4
OG0002946	1	1	1	1	4
OG0002947	1	1	1	1	4
OG0002948	1	1	0	2	4
OG0002949	2	1	0	1	4
OG0002950	1	1	1	1	4
OG0002951	1	1	1	1	4
OG0002952	1	1	1	1	4
OG0002953	1	1	1	1	4
OG0002954	1	1	1	1	4
OG0002955	1	1	1	1	4
OG0002956	1	1	1	1	4
OG0002957	1	1	1	1	4
OG0002958	4	0	0	0	4
OG0002959	1	1	1	1	4
OG0002960	1	1	1	1	4
OG0002961	4	0	0	0	4
OG0002962	1	1	1	1	4
OG0002963	1	3	0	0	4
OG0002964	1	1	1	1	4
OG0002965	1	1	1	1	4
OG0002966	2	1	1	0	4
OG0002967	1	1	1	1	4
OG0002968	2	1	1	0	4
OG0002969	1	1	1	1	4
OG0002970	1	1	1	1	4
OG0002971	1	1	1	1	4
OG0002972	1	1	1	1	4
OG0002973	1	1	0	2	4
OG0002974	1	1	1	1	4
OG0002975	1	1	2	0	4
OG0002976	1	1	1	1	4
OG0002977	1	1	1	1	4
OG0002978	1	1	1	1	4
OG0002979	1	1	1	1	4
OG0002980	1	1	2	0	4
OG0002981	1	1	1	1	4
OG0002982	1	1	1	1	4
OG0002983	1	1	1	1	4
OG0002984	1	2	1	0	4
OG0002985	1	1	1	1	4
OG0002986	1	1	1	1	4
OG0002987	1	1	1	1	4
OG0002988	1	1	1	1	4
OG0002989	1	1	1	1	4
OG0002990	2	1	0	1	4
OG0002991	2	1	1	0	4
OG0002992	1	1	0	2	4
OG0002993	1	1	1	1	4
OG0002994	1	1	1	1	4
OG0002995	1	1	1	1	4
OG0002996	1	1	1	1	4
OG0002997	1	1	1	1	4
OG0002998	1	1	2	0	4
OG0002999	1	1	1	1	4
OG0003000	1	1	1	1	4
OG0003001	1	1	1	1	4
OG0003002	2	1	0	1	4
OG0003003	2	1	1	0	4
OG0003004	1	1	1	1	4
OG0003005	1	1	1	1	4
OG0003006	1	1	1	1	4
OG0003007	1	1	1	1	4
OG0003008	1	1	1	1	4
OG0003009	1	1	1	1	4
OG0003010	1	1	1	1	4
OG0003011	1	1	1	1	4
OG0003012	1	1	1	1	4
OG0003013	1	1	1	1	4
OG0003014	2	1	1	0	4
OG0003015	1	1	1	1	4
OG0003016	1	1	1	1	4
OG0003017	1	1	1	1	4
OG0003018	1	1	1	1	4
OG0003019	1	1	1	1	4
OG0003020	1	1	2	0	4
OG0003021	1	1	1	1	4
OG0003022	1	0	2	1	4
OG0003023	1	1	1	1	4
OG0003024	1	1	0	2	4
OG0003025	1	1	1	1	4
OG0003026	1	1	1	1	4
OG0003027	1	1	1	1	4
OG0003028	1	1	1	1	4
OG0003029	1	1	1	1	4
OG0003030	1	1	1	1	4
OG0003031	1	1	1	1	4
OG0003032	2	1	1	0	4
OG0003033	1	1	1	1	4
OG0003034	1	1	1	1	4
OG0003035	1	1	1	1	4
OG0003036	1	1	1	1	4
OG0003037	1	1	2	0	4
OG0003038	1	1	1	1	4
OG0003039	1	1	1	1	4
OG0003040	1	1	1	1	4
OG0003041	1	1	1	1	4
OG0003042	1	1	1	1	4
OG0003043	2	1	1	0	4
OG0003044	1	1	1	1	4
OG0003045	1	1	1	1	4
OG0003046	1	1	1	1	4
OG0003047	1	1	1	1	4
OG0003048	1	0	3	0	4
OG0003049	2	0	1	1	4
OG0003050	1	1	0	2	4
OG0003051	1	1	1	1	4
OG0003052	1	1	1	1	4
OG0003053	1	1	1	1	4
OG0003054	1	1	1	1	4
OG0003055	1	0	1	2	4
OG0003056	1	1	1	1	4
OG0003057	1	1	1	1	4
OG0003058	2	1	0	1	4
OG0003059	1	1	1	1	4
OG0003060	2	1	0	1	4
OG0003061	1	1	1	1	4
OG0003062	1	1	1	1	4
OG0003063	1	1	1	1	4
OG0003064	1	1	1	1	4
OG0003065	1	1	1	1	4
OG0003066	1	1	1	1	4
OG0003067	1	1	1	1	4
OG0003068	1	1	1	1	4
OG0003069	1	1	2	0	4
OG0003070	1	1	1	1	4
OG0003071	1	1	1	1	4
OG0003072	1	1	1	1	4
OG0003073	1	3	0	0	4
OG0003074	2	1	1	0	4
OG0003075	1	2	0	1	4
OG0003076	1	1	1	1	4
OG0003077	1	1	1	1	4
OG0003078	1	1	1	1	4
OG0003079	1	1	1	1	4
OG0003080	1	1	1	1	4
OG0003081	1	1	1	1	4
OG0003082	1	1	1	1	4
OG0003083	1	1	1	1	4
OG0003084	2	1	0	1	4
OG0003085	2	1	0	1	4
OG0003086	1	1	1	1	4
OG0003087	1	1	1	1	4
OG0003088	1	1	1	1	4
OG0003089	1	1	1	1	4
OG0003090	1	1	1	1	4
OG0003091	1	1	1	1	4
OG0003092	1	1	1	1	4
OG0003093	2	1	0	1	4
OG0003094	1	1	1	1	4
OG0003095	2	2	0	0	4
OG0003096	1	2	1	0	4
OG0003097	1	1	1	1	4
OG0003098	1	1	1	1	4
OG0003099	1	1	1	1	4
OG0003100	1	1	1	1	4
OG0003101	1	1	1	1	4
OG0003102	1	1	1	1	4
OG0003103	1	1	1	1	4
OG0003104	1	1	1	1	4
OG0003105	1	1	1	1	4
OG0003106	2	1	1	0	4
OG0003107	1	1	1	1	4
OG0003108	2	1	0	1	4
OG0003109	1	1	1	1	4
OG0003110	1	1	1	1	4
OG0003111	1	1	1	1	4
OG0003112	1	1	1	1	4
OG0003113	1	1	1	1	4
OG0003114	1	1	1	1	4
OG0003115	1	0	1	2	4
OG0003116	1	1	1	1	4
OG0003117	1	1	1	1	4
OG0003118	1	1	1	1	4
OG0003119	1	1	1	1	4
OG0003120	1	1	1	1	4
OG0003121	1	1	1	1	4
OG0003122	1	1	1	1	4
OG0003123	1	1	1	1	4
OG0003124	1	1	1	1	4
OG0003125	1	1	1	1	4
OG0003126	1	1	1	1	4
OG0003127	1	1	1	1	4
OG0003128	1	1	1	1	4
OG0003129	1	2	1	0	4
OG0003130	2	1	0	1	4
OG0003131	1	0	0	3	4
OG0003132	2	1	1	0	4
OG0003133	1	1	2	0	4
OG0003134	1	1	1	1	4
OG0003135	1	1	1	1	4
OG0003136	1	1	1	1	4
OG0003137	1	1	1	1	4
OG0003138	1	1	0	2	4
OG0003139	1	1	1	1	4
OG0003140	1	1	1	1	4
OG0003141	1	1	0	2	4
OG0003142	1	1	0	2	4
OG0003143	1	1	1	1	4
OG0003144	1	1	1	1	4
OG0003145	1	1	1	1	4
OG0003146	1	1	1	1	4
OG0003147	1	1	2	0	4
OG0003148	1	2	0	1	4
OG0003149	1	1	1	1	4
OG0003150	1	1	1	1	4
OG0003151	1	1	1	1	4
OG0003152	1	1	1	1	4
OG0003153	1	1	1	1	4
OG0003154	1	1	1	1	4
OG0003155	1	1	1	1	4
OG0003156	1	1	1	1	4
OG0003157	1	1	1	1	4
OG0003158	1	1	1	1	4
OG0003159	1	1	1	1	4
OG0003160	1	1	1	1	4
OG0003161	1	1	1	1	4
OG0003162	1	2	0	1	4
OG0003163	1	1	0	2	4
OG0003164	1	1	1	1	4
OG0003165	1	1	1	1	4
OG0003166	1	1	1	1	4
OG0003167	2	1	1	0	4
OG0003168	1	2	0	1	4
OG0003169	1	1	1	1	4
OG0003170	1	1	1	1	4
OG0003171	2	1	1	0	4
OG0003172	1	1	1	1	4
OG0003173	1	1	1	1	4
OG0003174	1	1	1	1	4
OG0003175	1	1	1	1	4
OG0003176	1	1	1	1	4
OG0003177	1	1	1	1	4
OG0003178	1	1	2	0	4
OG0003179	1	1	1	1	4
OG0003180	2	1	0	1	4
OG0003181	2	1	1	0	4
OG0003182	2	1	0	1	4
OG0003183	1	1	1	1	4
OG0003184	2	1	0	1	4
OG0003185	1	1	1	1	4
OG0003186	2	1	0	1	4
OG0003187	1	1	1	1	4
OG0003188	1	0	0	3	4
OG0003189	1	1	1	1	4
OG0003190	2	1	1	0	4
OG0003191	1	1	2	0	4
OG0003192	2	1	0	1	4
OG0003193	1	1	1	1	4
OG0003194	1	1	1	1	4
OG0003195	1	1	1	1	4
OG0003196	1	0	2	1	4
OG0003197	1	1	1	1	4
OG0003198	2	1	0	1	4
OG0003199	2	1	0	1	4
OG0003200	2	1	1	0	4
OG0003201	1	1	1	1	4
OG0003202	1	1	1	1	4
OG0003203	1	1	1	1	4
OG0003204	1	1	1	1	4
OG0003205	1	1	1	1	4
OG0003206	1	1	1	1	4
OG0003207	1	1	1	1	4
OG0003208	1	1	1	1	4
OG0003209	2	1	1	0	4
OG0003210	1	1	1	1	4
OG0003211	1	1	1	1	4
OG0003212	1	1	1	1	4
OG0003213	1	1	1	1	4
OG0003214	2	1	1	0	4
OG0003215	1	1	1	1	4
OG0003216	2	1	0	1	4
OG0003217	4	0	0	0	4
OG0003218	2	1	1	0	4
OG0003219	1	1	1	1	4
OG0003220	1	1	1	1	4
OG0003221	1	1	1	1	4
OG0003222	2	1	1	0	4
OG0003223	2	1	0	1	4
OG0003224	1	1	1	1	4
OG0003225	1	1	1	1	4
OG0003226	1	1	1	1	4
OG0003227	1	1	1	1	4
OG0003228	1	1	1	1	4
OG0003229	1	0	2	1	4
OG0003230	1	1	1	1	4
OG0003231	1	1	1	1	4
OG0003232	1	1	1	1	4
OG0003233	2	0	1	1	4
OG0003234	2	1	0	1	4
OG0003235	1	1	1	1	4
OG0003236	1	1	1	1	4
OG0003237	1	1	0	2	4
OG0003238	1	1	1	1	4
OG0003239	1	2	0	1	4
OG0003240	1	1	1	1	4
OG0003241	2	0	1	1	4
OG0003242	1	1	2	0	4
OG0003243	1	1	1	1	4
OG0003244	1	1	1	1	4
OG0003245	1	1	1	1	4
OG0003246	2	1	1	0	4
OG0003247	2	1	0	1	4
OG0003248	1	1	1	1	4
OG0003249	2	1	1	0	4
OG0003250	1	1	1	1	4
OG0003251	1	1	1	1	4
OG0003252	2	0	1	1	4
OG0003253	2	1	1	0	4
OG0003254	1	1	1	1	4
OG0003255	1	1	1	1	4
OG0003256	1	2	0	1	4
OG0003257	1	1	1	1	4
OG0003258	2	1	1	0	4
OG0003259	1	1	1	1	4
OG0003260	1	1	1	1	4
OG0003261	1	1	1	1	4
OG0003262	1	1	1	1	4
OG0003263	2	1	1	0	4
OG0003264	1	1	1	1	4
OG0003265	1	1	1	1	4
OG0003266	1	1	1	1	4
OG0003267	1	1	1	1	4
OG0003268	1	2	1	0	4
OG0003269	1	1	1	1	4
OG0003270	2	1	0	1	4
OG0003271	1	1	1	1	4
OG0003272	2	1	1	0	4
OG0003273	1	1	1	1	4
OG0003274	2	0	1	1	4
OG0003275	1	1	1	1	4
OG0003276	1	1	1	1	4
OG0003277	1	1	1	1	4
OG0003278	1	1	1	1	4
OG0003279	2	1	1	0	4
OG0003280	1	1	1	1	4
OG0003281	1	1	1	1	4
OG0003282	1	1	1	1	4
OG0003283	1	1	1	1	4
OG0003284	1	1	1	1	4
OG0003285	1	1	1	1	4
OG0003286	1	1	0	2	4
OG0003287	1	1	0	2	4
OG0003288	1	1	1	1	4
OG0003289	2	1	1	0	4
OG0003290	2	1	0	1	4
OG0003291	1	1	1	1	4
OG0003292	2	1	0	1	4
OG0003293	1	1	1	1	4
OG0003294	2	1	0	1	4
OG0003295	3	1	0	0	4
OG0003296	1	1	1	1	4
OG0003297	2	0	1	1	4
OG0003298	1	1	1	1	4
OG0003299	1	1	1	1	4
OG0003300	1	1	1	1	4
OG0003301	1	1	1	1	4
OG0003302	1	1	1	1	4
OG0003303	1	1	1	1	4
OG0003304	1	1	1	1	4
OG0003305	1	1	1	1	4
OG0003306	1	1	1	1	4
OG0003307	1	1	1	1	4
OG0003308	2	1	0	1	4
OG0003309	1	1	1	1	4
OG0003310	2	1	1	0	4
OG0003311	1	1	1	1	4
OG0003312	1	1	1	1	4
OG0003313	1	1	2	0	4
OG0003314	1	1	1	1	4
OG0003315	2	1	1	0	4
OG0003316	1	1	1	1	4
OG0003317	1	1	1	1	4
OG0003318	1	1	1	1	4
OG0003319	1	1	1	1	4
OG0003320	1	1	1	1	4
OG0003321	1	1	1	1	4
OG0003322	3	1	0	0	4
OG0003323	1	1	1	1	4
OG0003324	1	1	1	1	4
OG0003325	1	1	1	1	4
OG0003326	3	0	1	0	4
OG0003327	2	1	1	0	4
OG0003328	1	1	1	1	4
OG0003329	1	1	1	1	4
OG0003330	1	1	1	1	4
OG0003331	1	1	1	1	4
OG0003332	1	1	2	0	4
OG0003333	1	1	1	1	4
OG0003334	1	1	1	1	4
OG0003335	2	1	1	0	4
OG0003336	1	1	1	1	4
OG0003337	1	1	1	1	4
OG0003338	2	1	0	1	4
OG0003339	1	1	1	1	4
OG0003340	1	1	1	1	4
OG0003341	1	1	1	1	4
OG0003342	1	0	2	1	4
OG0003343	1	1	0	2	4
OG0003344	1	1	1	1	4
OG0003345	1	1	1	1	4
OG0003346	1	1	1	1	4
OG0003347	2	1	0	1	4
OG0003348	1	1	1	1	4
OG0003349	1	1	1	1	4
OG0003350	1	1	1	1	4
OG0003351	1	1	2	0	4
OG0003352	1	1	1	1	4
OG0003353	1	1	1	1	4
OG0003354	2	1	0	1	4
OG0003355	1	1	1	1	4
OG0003356	1	1	1	1	4
OG0003357	1	1	2	0	4
OG0003358	1	1	1	1	4
OG0003359	1	1	0	2	4
OG0003360	1	1	0	2	4
OG0003361	1	1	1	1	4
OG0003362	1	1	1	1	4
OG0003363	1	1	2	0	4
OG0003364	1	1	2	0	4
OG0003365	1	1	1	1	4
OG0003366	1	1	1	1	4
OG0003367	1	1	0	2	4
OG0003368	1	1	1	1	4
OG0003369	1	1	1	1	4
OG0003370	1	1	1	1	4
OG0003371	2	1	1	0	4
OG0003372	1	1	1	1	4
OG0003373	1	1	1	1	4
OG0003374	2	1	0	1	4
OG0003375	1	1	1	1	4
OG0003376	1	1	1	1	4
OG0003377	1	1	1	1	4
OG0003378	1	1	1	1	4
OG0003379	1	1	1	1	4
OG0003380	1	2	0	1	4
OG0003381	1	1	1	1	4
OG0003382	1	0	2	1	4
OG0003383	1	1	1	1	4
OG0003384	1	1	1	1	4
OG0003385	1	1	1	1	4
OG0003386	1	1	1	1	4
OG0003387	1	1	1	1	4
OG0003388	1	1	1	1	4
OG0003389	1	1	1	1	4
OG0003390	2	0	1	1	4
OG0003391	2	1	0	1	4
OG0003392	1	1	1	1	4
OG0003393	1	1	1	1	4
OG0003394	1	1	1	1	4
OG0003395	1	1	1	1	4
OG0003396	1	1	1	1	4
OG0003397	2	1	1	0	4
OG0003398	1	1	1	1	4
OG0003399	1	1	1	1	4
OG0003400	1	1	1	1	4
OG0003401	1	1	1	1	4
OG0003402	1	1	1	1	4
OG0003403	1	1	1	1	4
OG0003404	1	1	1	1	4
OG0003405	2	1	1	0	4
OG0003406	1	1	1	1	4
OG0003407	1	1	1	1	4
OG0003408	4	0	0	0	4
OG0003409	2	0	1	1	4
OG0003410	2	1	0	1	4
OG0003411	1	1	1	1	4
OG0003412	2	1	1	0	4
OG0003413	1	1	1	1	4
OG0003414	2	1	1	0	4
OG0003415	1	1	1	1	4
OG0003416	1	1	1	1	4
OG0003417	2	1	1	0	4
OG0003418	3	1	0	0	4
OG0003419	1	1	1	1	4
OG0003420	1	2	1	0	4
OG0003421	1	1	1	1	4
OG0003422	1	1	1	1	4
OG0003423	1	1	1	1	4
OG0003424	1	0	1	2	4
OG0003425	1	1	1	1	4
OG0003426	1	1	1	1	4
OG0003427	1	1	1	1	4
OG0003428	3	0	1	0	4
OG0003429	1	1	1	1	4
OG0003430	1	2	1	0	4
OG0003431	1	1	1	1	4
OG0003432	1	1	1	1	4
OG0003433	1	1	1	1	4
OG0003434	2	1	0	1	4
OG0003435	1	1	1	1	4
OG0003436	1	1	1	1	4
OG0003437	2	1	1	0	4
OG0003438	2	0	1	1	4
OG0003439	1	1	1	1	4
OG0003440	2	1	0	1	4
OG0003441	1	1	1	1	4
OG0003442	1	1	1	1	4
OG0003443	1	1	1	1	4
OG0003444	2	1	1	0	4
OG0003445	2	1	0	1	4
OG0003446	1	1	1	1	4
OG0003447	1	1	1	1	4
OG0003448	2	1	1	0	4
OG0003449	1	1	1	1	4
OG0003450	3	1	0	0	4
OG0003451	1	1	1	1	4
OG0003452	1	1	1	1	4
OG0003453	1	1	1	1	4
OG0003454	1	1	1	1	4
OG0003455	1	1	1	1	4
OG0003456	1	1	1	1	4
OG0003457	1	1	1	1	4
OG0003458	2	1	0	1	4
OG0003459	2	1	1	0	4
OG0003460	1	1	1	1	4
OG0003461	1	1	1	1	4
OG0003462	1	1	1	1	4
OG0003463	1	1	1	1	4
OG0003464	1	1	2	0	4
OG0003465	1	1	1	1	4
OG0003466	1	1	1	1	4
OG0003467	1	1	1	1	4
OG0003468	1	1	1	1	4
OG0003469	1	1	1	1	4
OG0003470	1	1	1	1	4
OG0003471	2	1	0	1	4
OG0003472	2	1	0	1	4
OG0003473	2	1	0	1	4
OG0003474	1	1	2	0	4
OG0003475	1	1	1	1	4
OG0003476	3	1	0	0	4
OG0003477	1	1	1	1	4
OG0003478	1	1	1	1	4
OG0003479	1	1	1	1	4
OG0003480	2	1	1	0	4
OG0003481	1	1	1	1	4
OG0003482	1	1	1	1	4
OG0003483	1	1	1	1	4
OG0003484	3	1	0	0	4
OG0003485	1	1	1	1	4
OG0003486	1	1	2	0	4
OG0003487	1	1	0	2	4
OG0003488	2	1	1	0	4
OG0003489	1	1	1	1	4
OG0003490	2	1	1	0	4
OG0003491	1	1	1	1	4
OG0003492	1	1	1	1	4
OG0003493	1	1	1	1	4
OG0003494	1	1	0	2	4
OG0003495	1	1	1	1	4
OG0003496	1	1	1	1	4
OG0003497	2	1	0	1	4
OG0003498	1	1	1	1	4
OG0003499	1	1	1	1	4
OG0003500	1	1	1	1	4
OG0003501	1	1	1	1	4
OG0003502	2	1	1	0	4
OG0003503	1	2	0	1	4
OG0003504	1	1	1	1	4
OG0003505	1	1	1	1	4
OG0003506	1	1	1	1	4
OG0003507	1	1	1	1	4
OG0003508	1	1	1	1	4
OG0003509	2	1	1	0	4
OG0003510	2	1	0	1	4
OG0003511	1	1	2	0	4
OG0003512	1	1	1	1	4
OG0003513	1	1	1	1	4
OG0003514	1	1	1	1	4
OG0003515	1	1	1	1	4
OG0003516	2	1	1	0	4
OG0003517	1	1	1	1	4
OG0003518	1	1	1	1	4
OG0003519	1	1	1	1	4
OG0003520	1	1	1	1	4
OG0003521	1	0	2	1	4
OG0003522	1	1	1	1	4
OG0003523	1	1	1	1	4
OG0003524	1	1	0	2	4
OG0003525	2	1	0	1	4
OG0003526	3	1	0	0	4
OG0003527	1	1	1	1	4
OG0003528	1	1	1	1	4
OG0003529	1	2	0	1	4
OG0003530	1	1	1	1	4
OG0003531	1	1	1	1	4
OG0003532	3	0	0	1	4
OG0003533	2	1	0	1	4
OG0003534	1	1	1	1	4
OG0003535	1	1	1	1	4
OG0003536	1	1	1	1	4
OG0003537	1	1	1	1	4
OG0003538	1	1	1	1	4
OG0003539	1	1	1	1	4
OG0003540	2	1	1	0	4
OG0003541	1	1	1	1	4
OG0003542	1	1	1	1	4
OG0003543	1	1	1	1	4
OG0003544	1	0	2	1	4
OG0003545	1	1	1	1	4
OG0003546	1	1	1	1	4
OG0003547	2	1	1	0	4
OG0003548	3	1	0	0	4
OG0003549	1	1	1	1	4
OG0003550	1	1	1	1	4
OG0003551	1	1	1	1	4
OG0003552	1	1	1	1	4
OG0003553	1	1	1	1	4
OG0003554	2	1	1	0	4
OG0003555	1	1	1	1	4
OG0003556	1	1	1	1	4
OG0003557	1	1	1	1	4
OG0003558	1	1	1	1	4
OG0003559	1	1	1	1	4
OG0003560	1	1	1	1	4
OG0003561	1	1	1	1	4
OG0003562	1	1	1	1	4
OG0003563	1	1	1	1	4
OG0003564	1	1	1	1	4
OG0003565	1	1	1	1	4
OG0003566	1	1	1	1	4
OG0003567	1	1	1	1	4
OG0003568	2	1	1	0	4
OG0003569	1	1	1	1	4
OG0003570	1	1	1	1	4
OG0003571	2	1	0	1	4
OG0003572	1	1	1	1	4
OG0003573	1	1	1	1	4
OG0003574	1	1	1	1	4
OG0003575	1	1	1	1	4
OG0003576	1	1	1	1	4
OG0003577	1	1	1	1	4
OG0003578	1	1	1	1	4
OG0003579	1	1	2	0	4
OG0003580	1	1	1	1	4
OG0003581	1	1	1	1	4
OG0003582	1	1	1	1	4
OG0003583	1	1	2	0	4
OG0003584	1	1	1	1	4
OG0003585	1	1	1	1	4
OG0003586	1	1	1	1	4
OG0003587	1	1	1	1	4
OG0003588	2	1	0	1	4
OG0003589	1	1	1	1	4
OG0003590	1	1	1	1	4
OG0003591	1	1	1	1	4
OG0003592	1	1	1	1	4
OG0003593	2	1	0	1	4
OG0003594	1	1	1	1	4
OG0003595	1	1	1	1	4
OG0003596	1	0	2	1	4
OG0003597	2	1	0	1	4
OG0003598	1	1	1	1	4
OG0003599	1	1	1	1	4
OG0003600	1	1	1	1	4
OG0003601	1	1	2	0	4
OG0003602	1	1	1	1	4
OG0003603	2	1	1	0	4
OG0003604	2	1	1	0	4
OG0003605	1	1	1	1	4
OG0003606	1	1	1	1	4
OG0003607	1	1	1	1	4
OG0003608	1	1	1	1	4
OG0003609	1	1	1	1	4
OG0003610	1	1	1	1	4
OG0003611	2	1	1	0	4
OG0003612	1	1	1	1	4
OG0003613	2	1	1	0	4
OG0003614	3	1	0	0	4
OG0003615	2	1	0	1	4
OG0003616	1	1	1	1	4
OG0003617	1	1	1	1	4
OG0003618	1	1	1	1	4
OG0003619	2	1	0	1	4
OG0003620	2	1	0	1	4
OG0003621	3	1	0	0	4
OG0003622	1	1	2	0	4
OG0003623	1	1	1	1	4
OG0003624	2	0	1	1	4
OG0003625	1	1	1	1	4
OG0003626	1	1	1	1	4
OG0003627	1	1	1	1	4
OG0003628	1	0	2	1	4
OG0003629	1	1	1	1	4
OG0003630	1	1	1	1	4
OG0003631	1	1	1	1	4
OG0003632	1	1	1	1	4
OG0003633	2	1	1	0	4
OG0003634	1	1	1	1	4
OG0003635	1	1	1	1	4
OG0003636	1	1	1	1	4
OG0003637	1	2	0	1	4
OG0003638	2	1	0	1	4
OG0003639	1	1	1	1	4
OG0003640	1	0	2	1	4
OG0003641	1	1	1	1	4
OG0003642	1	1	2	0	4
OG0003643	1	1	1	1	4
OG0003644	1	0	1	2	4
OG0003645	4	0	0	0	4
OG0003646	1	1	1	1	4
OG0003647	1	1	1	1	4
OG0003648	2	0	1	1	4
OG0003649	1	1	1	1	4
OG0003650	1	0	1	2	4
OG0003651	1	1	1	1	4
OG0003652	2	1	1	0	4
OG0003653	1	1	1	1	4
OG0003654	1	1	1	1	4
OG0003655	1	1	1	1	4
OG0003656	1	1	0	2	4
OG0003657	1	1	1	1	4
OG0003658	1	1	1	1	4
OG0003659	1	1	1	1	4
OG0003660	2	1	0	1	4
OG0003661	1	1	1	1	4
OG0003662	1	1	1	1	4
OG0003663	3	1	0	0	4
OG0003664	2	2	0	0	4
OG0003665	2	1	1	0	4
OG0003666	1	1	2	0	4
OG0003667	1	1	1	1	4
OG0003668	2	0	1	1	4
OG0003669	1	1	1	1	4
OG0003670	1	1	1	1	4
OG0003671	1	1	1	1	4
OG0003672	1	1	1	1	4
OG0003673	1	1	1	1	4
OG0003674	2	1	1	0	4
OG0003675	1	1	1	1	4
OG0003676	1	1	1	1	4
OG0003677	1	1	0	2	4
OG0003678	1	1	1	1	4
OG0003679	1	1	2	0	4
OG0003680	3	1	0	0	4
OG0003681	1	1	1	1	4
OG0003682	1	1	1	1	4
OG0003683	1	1	1	1	4
OG0003684	1	1	1	1	4
OG0003685	1	1	1	1	4
OG0003686	1	1	2	0	4
OG0003687	1	1	0	2	4
OG0003688	1	1	1	1	4
OG0003689	2	1	0	1	4
OG0003690	2	1	1	0	4
OG0003691	1	1	1	1	4
OG0003692	1	1	1	1	4
OG0003693	1	1	1	1	4
OG0003694	1	1	1	1	4
OG0003695	1	1	1	1	4
OG0003696	1	1	1	1	4
OG0003697	1	1	1	1	4
OG0003698	1	1	1	1	4
OG0003699	1	1	1	1	4
OG0003700	1	1	1	1	4
OG0003701	1	1	1	1	4
OG0003702	1	1	1	1	4
OG0003703	1	0	1	2	4
OG0003704	1	1	1	1	4
OG0003705	2	1	1	0	4
OG0003706	1	1	2	0	4
OG0003707	1	1	1	1	4
OG0003708	1	1	1	1	4
OG0003709	1	1	1	1	4
OG0003710	2	1	1	0	4
OG0003711	1	1	1	1	4
OG0003712	1	1	1	1	4
OG0003713	1	1	1	1	4
OG0003714	1	1	0	2	4
OG0003715	1	0	0	3	4
OG0003716	1	1	1	1	4
OG0003717	2	1	1	0	4
OG0003718	1	1	1	1	4
OG0003719	1	1	1	1	4
OG0003720	1	1	1	1	4
OG0003721	1	1	1	1	4
OG0003722	1	1	0	2	4
OG0003723	1	1	1	1	4
OG0003724	1	1	1	1	4
OG0003725	1	1	1	1	4
OG0003726	1	1	1	1	4
OG0003727	1	1	1	1	4
OG0003728	1	1	1	1	4
OG0003729	1	1	1	1	4
OG0003730	1	1	2	0	4
OG0003731	1	1	1	1	4
OG0003732	1	1	1	1	4
OG0003733	1	1	1	1	4
OG0003734	1	1	2	0	4
OG0003735	1	1	1	1	4
OG0003736	1	1	1	1	4
OG0003737	1	1	1	1	4
OG0003738	1	2	1	0	4
OG0003739	1	1	1	1	4
OG0003740	2	0	1	1	4
OG0003741	1	1	1	1	4
OG0003742	1	1	1	1	4
OG0003743	1	1	1	1	4
OG0003744	4	0	0	0	4
OG0003745	1	1	1	1	4
OG0003746	2	1	1	0	4
OG0003747	1	1	1	1	4
OG0003748	1	1	1	1	4
OG0003749	1	1	1	1	4
OG0003750	1	1	1	1	4
OG0003751	1	1	1	1	4
OG0003752	2	1	0	1	4
OG0003753	1	1	1	1	4
OG0003754	2	0	1	1	4
OG0003755	1	2	0	1	4
OG0003756	1	0	3	0	4
OG0003757	1	1	1	1	4
OG0003758	1	1	1	1	4
OG0003759	1	1	1	1	4
OG0003760	1	1	1	1	4
OG0003761	1	1	1	1	4
OG0003762	1	1	1	1	4
OG0003763	1	1	1	1	4
OG0003764	1	1	1	1	4
OG0003765	1	1	1	1	4
OG0003766	1	1	1	1	4
OG0003767	1	1	1	1	4
OG0003768	1	1	1	1	4
OG0003769	1	1	1	1	4
OG0003770	1	1	1	1	4
OG0003771	1	1	1	1	4
OG0003772	1	0	2	1	4
OG0003773	1	1	1	1	4
OG0003774	1	1	1	1	4
OG0003775	1	1	1	1	4
OG0003776	1	1	1	1	4
OG0003777	1	1	1	1	4
OG0003778	1	1	1	1	4
OG0003779	2	1	1	0	4
OG0003780	1	1	1	1	4
OG0003781	1	1	1	1	4
OG0003782	1	1	1	1	4
OG0003783	1	1	1	1	4
OG0003784	1	1	1	1	4
OG0003785	1	1	1	1	4
OG0003786	2	1	1	0	4
OG0003787	1	3	0	0	4
OG0003788	1	1	1	1	4
OG0003789	1	1	1	1	4
OG0003790	1	1	1	1	4
OG0003791	1	1	1	1	4
OG0003792	2	1	1	0	4
OG0003793	1	1	1	1	4
OG0003794	1	1	1	1	4
OG0003795	1	1	1	1	4
OG0003796	1	1	1	1	4
OG0003797	1	1	1	1	4
OG0003798	1	1	1	1	4
OG0003799	1	1	1	1	4
OG0003800	1	1	1	1	4
OG0003801	1	1	1	1	4
OG0003802	1	1	1	1	4
OG0003803	1	1	1	1	4
OG0003804	1	1	1	1	4
OG0003805	1	1	1	1	4
OG0003806	1	1	1	1	4
OG0003807	1	1	1	1	4
OG0003808	2	1	0	1	4
OG0003809	2	0	1	1	4
OG0003810	1	1	1	1	4
OG0003811	1	1	1	1	4
OG0003812	1	1	1	1	4
OG0003813	1	1	1	1	4
OG0003814	1	1	1	1	4
OG0003815	1	1	1	1	4
OG0003816	2	1	1	0	4
OG0003817	1	0	1	2	4
OG0003818	1	1	1	1	4
OG0003819	2	1	1	0	4
OG0003820	4	0	0	0	4
OG0003821	2	1	0	1	4
OG0003822	1	1	1	1	4
OG0003823	4	0	0	0	4
OG0003824	1	1	1	1	4
OG0003825	1	1	1	1	4
OG0003826	1	1	1	1	4
OG0003827	1	1	1	1	4
OG0003828	1	1	1	1	4
OG0003829	1	1	1	1	4
OG0003830	1	1	1	1	4
OG0003831	1	1	1	1	4
OG0003832	1	1	1	1	4
OG0003833	2	1	0	1	4
OG0003834	1	1	1	1	4
OG0003835	1	1	1	1	4
OG0003836	1	1	1	1	4
OG0003837	1	1	1	1	4
OG0003838	1	1	1	1	4
OG0003839	1	1	1	1	4
OG0003840	1	1	1	1	4
OG0003841	1	1	1	1	4
OG0003842	3	1	0	0	4
OG0003843	2	1	1	0	4
OG0003844	1	1	1	1	4
OG0003845	1	1	0	2	4
OG0003846	1	1	1	1	4
OG0003847	2	1	1	0	4
OG0003848	1	1	1	1	4
OG0003849	1	1	1	1	4
OG0003850	1	1	1	1	4
OG0003851	1	1	1	1	4
OG0003852	1	1	1	1	4
OG0003853	1	1	1	1	4
OG0003854	1	1	1	1	4
OG0003855	3	1	0	0	4
OG0003856	1	1	1	1	4
OG0003857	1	1	1	1	4
OG0003858	2	1	0	1	4
OG0003859	2	0	1	1	4
OG0003860	1	1	1	1	4
OG0003861	1	1	1	1	4
OG0003862	1	1	1	1	4
OG0003863	1	1	1	1	4
OG0003864	1	0	1	2	4
OG0003865	1	1	1	1	4
OG0003866	1	1	1	1	4
OG0003867	1	1	1	1	4
OG0003868	1	1	1	1	4
OG0003869	1	1	1	1	4
OG0003870	1	1	1	1	4
OG0003871	1	1	1	1	4
OG0003872	2	1	1	0	4
OG0003873	1	1	1	1	4
OG0003874	1	1	1	1	4
OG0003875	1	1	1	1	4
OG0003876	1	1	1	1	4
OG0003877	1	1	0	2	4
OG0003878	2	1	1	0	4
OG0003879	2	2	0	0	4
OG0003880	1	1	1	1	4
OG0003881	1	1	1	1	4
OG0003882	1	1	1	1	4
OG0003883	1	0	1	2	4
OG0003884	1	1	1	1	4
OG0003885	1	0	1	2	4
OG0003886	1	1	1	1	4
OG0003887	1	1	1	1	4
OG0003888	1	1	1	1	4
OG0003889	1	1	1	1	4
OG0003890	1	1	1	1	4
OG0003891	1	1	2	0	4
OG0003892	2	1	1	0	4
OG0003893	1	1	1	1	4
OG0003894	1	1	1	1	4
OG0003895	1	1	1	1	4
OG0003896	1	1	1	1	4
OG0003897	2	1	1	0	4
OG0003898	1	1	1	1	4
OG0003899	1	1	1	1	4
OG0003900	1	1	1	1	4
OG0003901	3	1	0	0	4
OG0003902	1	1	2	0	4
OG0003903	1	1	1	1	4
OG0003904	1	1	1	1	4
OG0003905	1	1	1	1	4
OG0003906	1	1	0	2	4
OG0003907	1	1	1	1	4
OG0003908	1	1	1	1	4
OG0003909	1	1	1	1	4
OG0003910	1	1	1	1	4
OG0003911	1	1	1	1	4
OG0003912	1	1	1	1	4
OG0003913	1	1	2	0	4
OG0003914	2	0	2	0	4
OG0003915	1	1	1	1	4
OG0003916	3	0	1	0	4
OG0003917	1	1	1	1	4
OG0003918	1	1	1	1	4
OG0003919	1	1	1	1	4
OG0003920	1	1	1	1	4
OG0003921	1	1	1	1	4
OG0003922	1	1	1	1	4
OG0003923	1	1	1	1	4
OG0003924	1	1	1	1	4
OG0003925	1	1	1	1	4
OG0003926	1	1	1	1	4
OG0003927	1	1	1	1	4
OG0003928	1	1	1	1	4
OG0003929	1	1	1	1	4
OG0003930	2	1	0	1	4
OG0003931	1	1	1	1	4
OG0003932	1	1	1	1	4
OG0003933	3	0	0	1	4
OG0003934	1	1	1	1	4
OG0003935	2	1	0	1	4
OG0003936	1	1	1	1	4
OG0003937	1	1	1	1	4
OG0003938	1	1	1	1	4
OG0003939	2	1	1	0	4
OG0003940	1	1	1	1	4
OG0003941	1	0	1	2	4
OG0003942	1	1	1	1	4
OG0003943	1	1	2	0	4
OG0003944	1	1	1	1	4
OG0003945	1	1	1	1	4
OG0003946	1	1	1	1	4
OG0003947	1	1	1	1	4
OG0003948	1	1	1	1	4
OG0003949	1	1	1	1	4
OG0003950	2	1	0	1	4
OG0003951	1	1	1	1	4
OG0003952	1	1	1	1	4
OG0003953	1	1	1	1	4
OG0003954	2	1	1	0	4
OG0003955	1	1	1	1	4
OG0003956	1	1	1	1	4
OG0003957	1	1	1	1	4
OG0003958	1	1	1	1	4
OG0003959	1	1	2	0	4
OG0003960	1	1	1	1	4
OG0003961	1	1	1	1	4
OG0003962	1	1	1	1	4
OG0003963	1	1	1	1	4
OG0003964	1	1	1	1	4
OG0003965	1	1	1	1	4
OG0003966	2	1	1	0	4
OG0003967	2	1	0	1	4
OG0003968	1	1	1	1	4
OG0003969	1	1	1	1	4
OG0003970	1	1	1	1	4
OG0003971	1	1	1	1	4
OG0003972	1	1	1	1	4
OG0003973	1	1	1	1	4
OG0003974	1	1	1	1	4
OG0003975	1	1	1	1	4
OG0003976	1	1	1	1	4
OG0003977	1	2	1	0	4
OG0003978	1	1	1	1	4
OG0003979	1	1	1	1	4
OG0003980	1	1	1	1	4
OG0003981	1	1	1	1	4
OG0003982	2	1	1	0	4
OG0003983	1	1	1	1	4
OG0003984	1	1	1	1	4
OG0003985	1	1	1	1	4
OG0003986	1	1	1	1	4
OG0003987	1	1	1	1	4
OG0003988	1	1	0	2	4
OG0003989	1	1	1	1	4
OG0003990	1	1	1	1	4
OG0003991	2	2	0	0	4
OG0003992	1	1	1	1	4
OG0003993	1	1	1	1	4
OG0003994	1	1	1	1	4
OG0003995	1	1	1	1	4
OG0003996	1	1	1	1	4
OG0003997	1	1	2	0	4
OG0003998	2	1	1	0	4
OG0003999	2	1	1	0	4
OG0004000	2	1	0	1	4
OG0004001	1	1	1	1	4
OG0004002	1	1	1	1	4
OG0004003	2	1	1	0	4
OG0004004	3	0	1	0	4
OG0004005	1	1	1	1	4
OG0004006	1	1	1	1	4
OG0004007	1	1	1	1	4
OG0004008	1	1	1	1	4
OG0004009	1	1	1	1	4
OG0004010	1	1	1	1	4
OG0004011	1	1	1	1	4
OG0004012	1	1	1	1	4
OG0004013	1	1	1	1	4
OG0004014	1	1	1	1	4
OG0004015	1	1	1	1	4
OG0004016	1	1	1	1	4
OG0004017	1	1	1	1	4
OG0004018	1	1	1	1	4
OG0004019	1	1	1	1	4
OG0004020	1	1	1	1	4
OG0004021	1	1	2	0	4
OG0004022	1	1	1	1	4
OG0004023	1	1	1	1	4
OG0004024	1	1	0	2	4
OG0004025	1	1	1	1	4
OG0004026	1	1	1	1	4
OG0004027	1	1	1	1	4
OG0004028	1	1	1	1	4
OG0004029	1	1	1	1	4
OG0004030	1	1	1	1	4
OG0004031	1	1	1	1	4
OG0004032	1	1	1	1	4
OG0004033	1	1	1	1	4
OG0004034	1	1	1	1	4
OG0004035	1	1	1	1	4
OG0004036	1	1	1	1	4
OG0004037	1	1	1	1	4
OG0004038	1	1	1	1	4
OG0004039	1	1	1	1	4
OG0004040	1	1	2	0	4
OG0004041	1	1	1	1	4
OG0004042	1	1	1	1	4
OG0004043	1	1	1	1	4
OG0004044	1	1	1	1	4
OG0004045	1	1	1	1	4
OG0004046	1	1	1	1	4
OG0004047	1	1	1	1	4
OG0004048	1	1	1	1	4
OG0004049	1	0	1	2	4
OG0004050	1	1	1	1	4
OG0004051	1	1	1	1	4
OG0004052	1	1	1	1	4
OG0004053	1	1	2	0	4
OG0004054	1	1	1	1	4
OG0004055	1	1	1	1	4
OG0004056	1	1	1	1	4
OG0004057	1	1	1	1	4
OG0004058	1	1	1	1	4
OG0004059	1	1	1	1	4
OG0004060	1	1	1	1	4
OG0004061	1	1	1	1	4
OG0004062	1	1	1	1	4
OG0004063	1	1	1	1	4
OG0004064	1	1	1	1	4
OG0004065	1	1	1	1	4
OG0004066	1	1	1	1	4
OG0004067	1	1	1	1	4
OG0004068	1	1	1	1	4
OG0004069	1	1	1	1	4
OG0004070	1	1	0	2	4
OG0004071	1	0	2	1	4
OG0004072	1	1	0	2	4
OG0004073	1	1	1	1	4
OG0004074	1	1	1	1	4
OG0004075	1	1	1	1	4
OG0004076	1	1	1	1	4
OG0004077	1	1	1	1	4
OG0004078	1	1	1	1	4
OG0004079	1	1	1	1	4
OG0004080	1	1	1	1	4
OG0004081	1	1	1	1	4
OG0004082	1	2	0	1	4
OG0004083	1	1	1	1	4
OG0004084	1	1	1	1	4
OG0004085	1	1	1	1	4
OG0004086	1	1	1	1	4
OG0004087	1	1	1	1	4
OG0004088	1	1	1	1	4
OG0004089	1	1	1	1	4
OG0004090	1	1	1	1	4
OG0004091	1	1	1	1	4
OG0004092	1	1	1	1	4
OG0004093	1	1	1	1	4
OG0004094	1	1	1	1	4
OG0004095	1	1	1	1	4
OG0004096	1	1	1	1	4
OG0004097	1	1	1	1	4
OG0004098	1	1	1	1	4
OG0004099	1	1	1	1	4
OG0004100	1	1	1	1	4
OG0004101	1	1	1	1	4
OG0004102	1	1	2	0	4
OG0004103	1	1	1	1	4
OG0004104	1	1	1	1	4
OG0004105	1	1	1	1	4
OG0004106	1	1	1	1	4
OG0004107	1	1	1	1	4
OG0004108	1	1	1	1	4
OG0004109	1	1	1	1	4
OG0004110	1	1	1	1	4
OG0004111	1	1	1	1	4
OG0004112	1	1	1	1	4
OG0004113	1	1	1	1	4
OG0004114	1	1	1	1	4
OG0004115	1	1	1	1	4
OG0004116	1	1	1	1	4
OG0004117	1	1	1	1	4
OG0004118	1	1	1	1	4
OG0004119	1	1	1	1	4
OG0004120	1	1	1	1	4
OG0004121	1	1	1	1	4
OG0004122	1	1	1	1	4
OG0004123	1	1	1	1	4
OG0004124	1	1	1	1	4
OG0004125	1	1	1	1	4
OG0004126	1	1	0	2	4
OG0004127	1	1	1	1	4
OG0004128	1	1	1	1	4
OG0004129	1	1	1	1	4
OG0004130	1	1	1	1	4
OG0004131	1	1	1	1	4
OG0004132	1	1	0	2	4
OG0004133	1	1	1	1	4
OG0004134	1	1	1	1	4
OG0004135	1	1	1	1	4
OG0004136	1	1	1	1	4
OG0004137	1	1	1	1	4
OG0004138	1	1	1	1	4
OG0004139	1	0	1	2	4
OG0004140	1	1	2	0	4
OG0004141	1	1	1	1	4
OG0004142	1	1	1	1	4
OG0004143	1	1	1	1	4
OG0004144	1	1	1	1	4
OG0004145	1	1	1	1	4
OG0004146	1	1	1	1	4
OG0004147	1	1	2	0	4
OG0004148	1	1	1	1	4
OG0004149	1	1	1	1	4
OG0004150	1	1	1	1	4
OG0004151	1	1	1	1	4
OG0004152	1	2	0	1	4
OG0004153	1	1	1	1	4
OG0004154	1	1	1	1	4
OG0004155	1	1	1	1	4
OG0004156	1	1	1	1	4
OG0004157	1	1	1	1	4
OG0004158	1	1	0	2	4
OG0004159	1	1	2	0	4
OG0004160	1	1	1	1	4
OG0004161	1	1	1	1	4
OG0004162	1	1	1	1	4
OG0004163	1	1	1	1	4
OG0004164	1	1	1	1	4
OG0004165	1	1	1	1	4
OG0004166	1	1	1	1	4
OG0004167	1	1	1	1	4
OG0004168	1	1	1	1	4
OG0004169	1	1	1	1	4
OG0004170	1	1	1	1	4
OG0004171	1	1	1	1	4
OG0004172	1	1	1	1	4
OG0004173	1	1	1	1	4
OG0004174	1	1	1	1	4
OG0004175	1	1	1	1	4
OG0004176	1	1	1	1	4
OG0004177	1	1	1	1	4
OG0004178	1	1	1	1	4
OG0004179	1	1	1	1	4
OG0004180	1	0	2	1	4
OG0004181	1	1	0	2	4
OG0004182	1	1	1	1	4
OG0004183	1	1	1	1	4
OG0004184	1	1	1	1	4
OG0004185	1	1	1	1	4
OG0004186	1	1	1	1	4
OG0004187	1	1	1	1	4
OG0004188	1	1	1	1	4
OG0004189	1	1	1	1	4
OG0004190	1	1	1	1	4
OG0004191	1	1	1	1	4
OG0004192	1	1	1	1	4
OG0004193	1	1	1	1	4
OG0004194	1	1	1	1	4
OG0004195	1	1	1	1	4
OG0004196	1	1	1	1	4
OG0004197	1	1	1	1	4
OG0004198	1	1	1	1	4
OG0004199	1	1	1	1	4
OG0004200	1	1	1	1	4
OG0004201	1	1	1	1	4
OG0004202	1	1	1	1	4
OG0004203	1	1	1	1	4
OG0004204	1	1	1	1	4
OG0004205	1	1	1	1	4
OG0004206	1	1	1	1	4
OG0004207	1	1	1	1	4
OG0004208	1	1	1	1	4
OG0004209	1	1	0	2	4
OG0004210	1	0	2	1	4
OG0004211	1	1	1	1	4
OG0004212	1	1	1	1	4
OG0004213	1	1	1	1	4
OG0004214	1	1	1	1	4
OG0004215	1	1	1	1	4
OG0004216	1	1	1	1	4
OG0004217	1	1	1	1	4
OG0004218	1	1	1	1	4
OG0004219	1	1	1	1	4
OG0004220	1	1	1	1	4
OG0004221	1	1	1	1	4
OG0004222	1	1	1	1	4
OG0004223	1	1	1	1	4
OG0004224	1	1	1	1	4
OG0004225	1	1	1	1	4
OG0004226	1	1	1	1	4
OG0004227	1	1	1	1	4
OG0004228	1	1	1	1	4
OG0004229	1	1	1	1	4
OG0004230	1	1	1	1	4
OG0004231	1	1	1	1	4
OG0004232	1	0	2	1	4
OG0004233	1	1	1	1	4
OG0004234	1	1	0	2	4
OG0004235	1	2	1	0	4
OG0004236	1	1	1	1	4
OG0004237	1	1	2	0	4
OG0004238	1	1	1	1	4
OG0004239	1	1	1	1	4
OG0004240	1	1	1	1	4
OG0004241	1	1	1	1	4
OG0004242	1	1	1	1	4
OG0004243	1	1	1	1	4
OG0004244	1	0	2	1	4
OG0004245	1	1	1	1	4
OG0004246	1	1	1	1	4
OG0004247	1	1	1	1	4
OG0004248	1	1	1	1	4
OG0004249	1	1	1	1	4
OG0004250	1	1	1	1	4
OG0004251	1	1	1	1	4
OG0004252	1	1	1	1	4
OG0004253	1	1	0	2	4
OG0004254	1	1	1	1	4
OG0004255	1	1	1	1	4
OG0004256	1	1	1	1	4
OG0004257	1	1	1	1	4
OG0004258	1	1	1	1	4
OG0004259	1	1	1	1	4
OG0004260	1	1	1	1	4
OG0004261	1	1	1	1	4
OG0004262	1	1	1	1	4
OG0004263	1	1	2	0	4
OG0004264	1	1	1	1	4
OG0004265	1	1	1	1	4
OG0004266	1	1	1	1	4
OG0004267	1	1	1	1	4
OG0004268	1	1	1	1	4
OG0004269	1	1	1	1	4
OG0004270	1	1	1	1	4
OG0004271	1	2	0	1	4
OG0004272	1	1	0	2	4
OG0004273	1	1	1	1	4
OG0004274	1	1	1	1	4
OG0004275	1	1	1	1	4
OG0004276	1	1	1	1	4
OG0004277	1	1	1	1	4
OG0004278	1	1	1	1	4
OG0004279	1	1	1	1	4
OG0004280	1	1	1	1	4
OG0004281	1	1	1	1	4
OG0004282	1	1	1	1	4
OG0004283	1	1	1	1	4
OG0004284	1	1	1	1	4
OG0004285	1	1	1	1	4
OG0004286	1	1	1	1	4
OG0004287	1	1	1	1	4
OG0004288	1	1	1	1	4
OG0004289	1	1	1	1	4
OG0004290	1	1	1	1	4
OG0004291	1	1	1	1	4
OG0004292	1	1	1	1	4
OG0004293	1	1	1	1	4
OG0004294	1	1	1	1	4
OG0004295	1	1	1	1	4
OG0004296	1	1	1	1	4
OG0004297	1	1	1	1	4
OG0004298	1	2	1	0	4
OG0004299	1	1	1	1	4
OG0004300	1	1	1	1	4
OG0004301	1	2	1	0	4
OG0004302	1	1	1	1	4
OG0004303	1	1	1	1	4
OG0004304	1	1	1	1	4
OG0004305	1	1	1	1	4
OG0004306	1	1	1	1	4
OG0004307	1	1	1	1	4
OG0004308	1	1	1	1	4
OG0004309	1	1	1	1	4
OG0004310	1	1	1	1	4
OG0004311	1	1	1	1	4
OG0004312	1	1	1	1	4
OG0004313	1	1	0	2	4
OG0004314	1	2	0	1	4
OG0004315	1	1	1	1	4
OG0004316	1	1	1	1	4
OG0004317	1	1	1	1	4
OG0004318	1	1	1	1	4
OG0004319	1	1	1	1	4
OG0004320	1	1	1	1	4
OG0004321	1	1	1	1	4
OG0004322	1	1	1	1	4
OG0004323	1	1	1	1	4
OG0004324	1	1	1	1	4
OG0004325	1	1	1	1	4
OG0004326	1	1	1	1	4
OG0004327	1	1	1	1	4
OG0004328	1	1	1	1	4
OG0004329	1	1	1	1	4
OG0004330	0	1	1	2	4
OG0004331	0	2	1	1	4
OG0004332	0	1	2	1	4
OG0004333	0	1	2	1	4
OG0004334	0	1	1	2	4
OG0004335	0	1	2	1	4
OG0004336	0	1	3	0	4
OG0004337	0	1	2	1	4
OG0004338	0	1	1	2	4
OG0004339	0	2	1	1	4
OG0004340	0	1	2	1	4
OG0004341	0	2	2	0	4
OG0004342	0	2	1	1	4
OG0004343	0	3	1	0	4
OG0004344	0	4	0	0	4
OG0004345	0	2	2	0	4
OG0004346	0	1	2	1	4
OG0004347	0	1	2	1	4
OG0004348	0	1	1	2	4
OG0004349	0	1	1	2	4
OG0004350	0	1	1	2	4
OG0004351	0	1	1	2	4
OG0004352	0	1	2	1	4
OG0004353	0	1	2	1	4
OG0004354	0	1	1	2	4
OG0004355	0	1	1	2	4
OG0004356	0	1	1	2	4
OG0004357	0	1	1	2	4
OG0004358	0	1	2	1	4
OG0004359	0	2	1	1	4
OG0004360	0	2	1	1	4
OG0004361	0	1	2	1	4
OG0004362	0	4	0	0	4
OG0004363	0	2	0	2	4
OG0004364	0	1	2	1	4
OG0004365	0	1	1	2	4
OG0004366	0	1	2	1	4
OG0004367	0	1	1	2	4
OG0004368	0	2	1	1	4
OG0004369	0	4	0	0	4
OG0004370	0	1	2	1	4
OG0004371	0	1	1	2	4
OG0004372	0	1	1	2	4
OG0004373	0	1	1	2	4
OG0004374	0	1	1	2	4
OG0004375	0	2	1	1	4
OG0004376	0	1	2	1	4
OG0004377	0	2	1	1	4
OG0004378	0	2	1	1	4
OG0004379	0	1	2	1	4
OG0004380	0	1	2	1	4
OG0004381	0	1	2	1	4
OG0004382	0	1	2	1	4
OG0004383	0	1	1	2	4
OG0004384	0	1	1	2	4
OG0004385	0	1	2	1	4
OG0004386	0	2	1	1	4
OG0004387	0	1	2	1	4
OG0004388	0	1	1	2	4
OG0004389	0	1	2	1	4
OG0004390	0	1	0	3	4
OG0004391	0	1	2	1	4
OG0004392	0	1	1	2	4
OG0004393	0	1	2	1	4
OG0004394	0	1	2	1	4
OG0004395	0	1	1	2	4
OG0004396	0	2	1	1	4
OG0004397	0	2	1	1	4
OG0004398	0	2	1	1	4
OG0004399	0	1	1	2	4
OG0004400	0	1	2	1	4
OG0004401	0	2	1	1	4
OG0004402	0	1	1	2	4
OG0004403	0	1	1	2	4
OG0004404	0	1	1	2	4
OG0004405	0	2	1	1	4
OG0004406	0	1	1	2	4
OG0004407	0	1	1	2	4
OG0004408	0	3	1	0	4
OG0004409	0	2	1	1	4
OG0004410	0	1	2	1	4
OG0004411	0	2	1	1	4
OG0004412	0	1	2	1	4
OG0004413	0	2	1	1	4
OG0004414	0	1	2	1	4
OG0004415	0	2	1	1	4
OG0004416	0	1	1	2	4
OG0004417	0	2	2	0	4
OG0004418	0	2	1	1	4
OG0004419	0	1	1	2	4
OG0004420	0	1	2	1	4
OG0004421	0	1	1	2	4
OG0004422	0	2	1	1	4
OG0004423	0	2	1	1	4
OG0004424	0	2	1	1	4
OG0004425	0	2	1	1	4
OG0004426	0	1	2	1	4
OG0004427	0	1	1	2	4
OG0004428	0	1	1	2	4
OG0004429	0	2	1	1	4
OG0004430	0	1	1	2	4
OG0004431	0	1	0	3	4
OG0004432	0	1	1	2	4
OG0004433	0	2	1	1	4
OG0004434	0	1	2	1	4
OG0004435	0	2	1	1	4
OG0004436	0	1	2	1	4
OG0004437	0	1	1	2	4
OG0004438	0	4	0	0	4
OG0004439	0	1	1	2	4
OG0004440	0	2	2	0	4
OG0004441	0	2	1	1	4
OG0004442	0	1	2	1	4
OG0004443	0	2	1	1	4
OG0004444	0	2	1	1	4
OG0004445	0	2	1	1	4
OG0004446	0	1	3	0	4
OG0004447	0	1	1	2	4
OG0004448	0	2	1	1	4
OG0004449	0	3	0	1	4
OG0004450	0	1	2	1	4
OG0004451	0	1	1	2	4
OG0004452	0	2	1	1	4
OG0004453	0	1	1	2	4
OG0004454	0	1	1	2	4
OG0004455	0	1	1	2	4
OG0004456	0	1	1	2	4
OG0004457	0	1	1	2	4
OG0004458	0	1	1	2	4
OG0004459	0	1	1	2	4
OG0004460	0	1	1	2	4
OG0004461	0	2	2	0	4
OG0004462	0	1	1	2	4
OG0004463	0	1	1	2	4
OG0004464	0	1	2	1	4
OG0004465	0	1	1	2	4
OG0004466	0	1	1	2	4
OG0004467	0	2	1	1	4
OG0004468	0	1	2	1	4
OG0004469	0	1	1	2	4
OG0004470	0	1	1	2	4
OG0004471	0	1	0	3	4
OG0004472	0	1	1	2	4
OG0004473	0	1	1	2	4
OG0004474	0	1	2	1	4
OG0004475	0	1	1	2	4
OG0004476	0	2	1	1	4
OG0004477	0	1	1	2	4
OG0004478	0	1	1	2	4
OG0004479	0	1	2	1	4
OG0004480	0	3	1	0	4
OG0004481	0	2	1	1	4
OG0004482	0	1	2	1	4
OG0004483	0	1	1	2	4
OG0004484	0	1	2	1	4
OG0004485	0	1	2	1	4
OG0004486	0	1	2	1	4
OG0004487	0	1	1	2	4
OG0004488	0	2	1	1	4
OG0004489	0	1	2	1	4
OG0004490	0	1	1	2	4
OG0004491	0	1	1	2	4
OG0004492	0	1	1	2	4
OG0004493	0	1	2	1	4
OG0004494	0	1	2	1	4
OG0004495	0	4	0	0	4
OG0004496	0	4	0	0	4
OG0004497	0	1	2	1	4
OG0004498	0	1	2	1	4
OG0004499	0	1	1	2	4
OG0004500	0	2	1	1	4
OG0004501	0	2	1	1	4
OG0004502	0	1	2	1	4
OG0004503	0	2	1	1	4
OG0004504	0	1	1	2	4
OG0004505	0	2	1	1	4
OG0004506	0	1	2	1	4
OG0004507	0	1	1	2	4
OG0004508	0	2	2	0	4
OG0004509	0	1	1	2	4
OG0004510	0	1	2	1	4
OG0004511	0	2	1	1	4
OG0004512	0	1	2	1	4
OG0004513	0	1	3	0	4
OG0004514	0	1	1	2	4
OG0004515	0	1	2	1	4
OG0004516	0	4	0	0	4
OG0004517	0	1	2	1	4
OG0004518	0	1	2	1	4
OG0004519	0	1	1	2	4
OG0004520	0	1	2	1	4
OG0004521	0	1	1	2	4
OG0004522	0	1	2	1	4
OG0004523	0	1	2	1	4
OG0004524	0	1	1	2	4
OG0004525	0	1	1	2	4
OG0004526	0	1	0	3	4
OG0004527	0	1	1	2	4
OG0004528	0	2	1	1	4
OG0004529	0	1	2	1	4
OG0004530	0	4	0	0	4
OG0004531	0	1	1	2	4
OG0004532	0	1	1	2	4
OG0004533	0	1	2	1	4
OG0004534	0	1	1	2	4
OG0004535	0	1	1	2	4
OG0004536	0	1	1	2	4
OG0004537	0	2	2	0	4
OG0004538	0	1	1	2	4
OG0004539	0	1	1	2	4
OG0004540	0	1	1	2	4
OG0004541	0	4	0	0	4
OG0004542	0	1	1	2	4
OG0004543	0	1	2	1	4
OG0004544	0	2	1	1	4
OG0004545	0	1	1	2	4
OG0004546	0	1	2	1	4
OG0004547	0	2	1	1	4
OG0004548	0	1	1	2	4
OG0004549	0	2	1	1	4
OG0004550	0	1	1	2	4
OG0004551	0	2	1	1	4
OG0004552	0	1	2	1	4
OG0004553	0	1	2	1	4
OG0004554	0	1	2	1	4
OG0004555	0	1	2	1	4
OG0004556	0	1	1	2	4
OG0004557	0	1	2	1	4
OG0004558	0	1	1	2	4
OG0004559	0	1	2	1	4
OG0004560	0	1	1	2	4
OG0004561	0	1	1	2	4
OG0004562	0	2	1	1	4
OG0004563	0	1	1	2	4
OG0004564	0	1	2	1	4
OG0004565	0	2	2	0	4
OG0004566	0	1	2	1	4
OG0004567	0	1	2	1	4
OG0004568	0	1	1	2	4
OG0004569	0	1	1	2	4
OG0004570	0	1	3	0	4
OG0004571	0	2	1	1	4
OG0004572	0	1	1	2	4
OG0004573	0	1	1	2	4
OG0004574	0	1	1	2	4
OG0004575	0	2	1	1	4
OG0004576	0	1	2	1	4
OG0004577	0	4	0	0	4
OG0004578	0	1	1	2	4
OG0004579	0	2	1	1	4
OG0004580	0	1	2	1	4
OG0004581	0	1	2	1	4
OG0004582	0	1	2	1	4
OG0004583	0	2	0	2	4
OG0004584	0	1	2	1	4
OG0004585	0	1	1	2	4
OG0004586	0	1	1	2	4
OG0004587	0	1	1	2	4
OG0004588	0	1	1	2	4
OG0004589	0	2	1	1	4
OG0004590	0	1	2	1	4
OG0004591	0	1	2	1	4
OG0004592	0	1	2	1	4
OG0004593	0	1	1	2	4
OG0004594	0	1	1	2	4
OG0004595	0	1	2	1	4
OG0004596	0	1	2	1	4
OG0004597	0	1	2	1	4
OG0004598	0	1	2	1	4
OG0004599	0	2	1	1	4
OG0004600	0	2	1	1	4
OG0004601	0	1	2	1	4
OG0004602	0	1	1	2	4
OG0004603	0	1	1	2	4
OG0004604	0	1	2	1	4
OG0004605	0	1	1	2	4
OG0004606	0	1	2	1	4
OG0004607	0	1	1	2	4
OG0004608	0	1	2	1	4
OG0004609	0	1	3	0	4
OG0004610	0	2	1	1	4
OG0004611	0	2	1	1	4
OG0004612	0	1	1	2	4
OG0004613	0	1	1	2	4
OG0004614	0	1	2	1	4
OG0004615	0	2	1	1	4
OG0004616	0	1	2	1	4
OG0004617	0	1	2	1	4
OG0004618	0	1	3	0	4
OG0004619	0	1	3	0	4
OG0004620	0	1	2	1	4
OG0004621	0	1	1	2	4
OG0004622	0	2	1	1	4
OG0004623	0	1	1	2	4
OG0004624	0	1	1	2	4
OG0004625	0	1	2	1	4
OG0004626	0	1	1	2	4
OG0004627	0	1	1	2	4
OG0004628	0	1	2	1	4
OG0004629	0	2	1	1	4
OG0004630	0	1	1	2	4
OG0004631	0	1	1	2	4
OG0004632	0	1	3	0	4
OG0004633	0	4	0	0	4
OG0004634	0	1	1	2	4
OG0004635	0	2	1	1	4
OG0004636	0	2	1	1	4
OG0004637	0	1	1	2	4
OG0004638	0	1	1	2	4
OG0004639	0	1	3	0	4
OG0004640	0	1	2	1	4
OG0004641	0	1	2	1	4
OG0004642	0	2	1	1	4
OG0004643	0	1	2	1	4
OG0004644	0	3	0	1	4
OG0004645	0	1	2	1	4
OG0004646	0	1	2	1	4
OG0004647	0	1	1	2	4
OG0004648	0	1	2	1	4
OG0004649	0	2	1	1	4
OG0004650	0	2	1	1	4
OG0004651	0	1	1	2	4
OG0004652	0	1	1	2	4
OG0004653	0	1	1	2	4
OG0004654	0	2	0	2	4
OG0004655	0	1	2	1	4
OG0004656	0	1	2	1	4
OG0004657	0	1	0	3	4
OG0004658	0	2	1	1	4
OG0004659	0	2	1	1	4
OG0004660	0	1	1	2	4
OG0004661	0	1	2	1	4
OG0004662	0	1	2	1	4
OG0004663	0	2	1	1	4
OG0004664	0	1	1	2	4
OG0004665	0	1	2	1	4
OG0004666	0	1	1	2	4
OG0004667	0	1	2	1	4
OG0004668	0	4	0	0	4
OG0004669	0	1	2	1	4
OG0004670	0	1	1	2	4
OG0004671	0	1	1	2	4
OG0004672	0	2	1	1	4
OG0004673	0	1	2	1	4
OG0004674	0	1	3	0	4
OG0004675	0	1	1	2	4
OG0004676	0	1	2	1	4
OG0004677	0	2	2	0	4
OG0004678	0	1	1	2	4
OG0004679	0	1	1	2	4
OG0004680	0	1	2	1	4
OG0004681	0	1	2	1	4
OG0004682	0	1	1	2	4
OG0004683	0	1	1	2	4
OG0004684	0	1	2	1	4
OG0004685	0	1	2	1	4
OG0004686	0	1	1	2	4
OG0004687	0	1	3	0	4
OG0004688	0	1	1	2	4
OG0004689	0	1	2	1	4
OG0004690	0	1	1	2	4
OG0004691	0	1	1	2	4
OG0004692	0	1	1	2	4
OG0004693	0	1	2	1	4
OG0004694	0	1	1	2	4
OG0004695	0	2	1	1	4
OG0004696	0	1	1	2	4
OG0004697	0	1	0	3	4
OG0004698	0	1	2	1	4
OG0004699	0	1	2	1	4
OG0004700	0	1	1	2	4
OG0004701	0	1	1	2	4
OG0004702	0	1	2	1	4
OG0004703	0	1	2	1	4
OG0004704	0	1	2	1	4
OG0004705	0	1	2	1	4
OG0004706	0	1	2	1	4
OG0004707	0	1	1	2	4
OG0004708	0	1	2	1	4
OG0004709	0	2	1	1	4
OG0004710	0	2	1	1	4
OG0004711	0	1	2	1	4
OG0004712	0	2	1	1	4
OG0004713	0	1	1	2	4
OG0004714	0	1	0	3	4
OG0004715	0	1	1	2	4
OG0004716	0	1	1	2	4
OG0004717	0	2	1	1	4
OG0004718	0	1	2	1	4
OG0004719	0	1	2	1	4
OG0004720	0	1	0	3	4
OG0004721	0	1	2	1	4
OG0004722	0	1	2	1	4
OG0004723	0	1	2	1	4
OG0004724	0	1	1	2	4
OG0004725	0	1	2	1	4
OG0004726	0	1	2	1	4
OG0004727	0	1	0	3	4
OG0004728	0	2	1	1	4
OG0004729	0	1	1	2	4
OG0004730	0	1	1	2	4
OG0004731	0	1	2	1	4
OG0004732	0	1	2	1	4
OG0004733	0	1	1	2	4
OG0004734	0	1	1	2	4
OG0004735	0	1	1	2	4
OG0004736	0	1	1	2	4
OG0004737	0	1	2	1	4
OG0004738	0	1	2	1	4
OG0004739	0	1	1	2	4
OG0004740	0	2	0	2	4
OG0004741	0	1	2	1	4
OG0004742	0	1	1	2	4
OG0004743	0	2	1	1	4
OG0004744	0	1	1	2	4
OG0004745	0	1	2	1	4
OG0004746	0	1	1	2	4
OG0004747	0	1	1	2	4
OG0004748	0	1	1	2	4
OG0004749	0	1	2	1	4
OG0004750	0	1	2	1	4
OG0004751	0	1	3	0	4
OG0004752	0	1	2	1	4
OG0004753	0	1	2	1	4
OG0004754	0	1	2	1	4
OG0004755	0	1	2	1	4
OG0004756	0	1	0	3	4
OG0004757	0	1	2	1	4
OG0004758	0	2	1	1	4
OG0004759	0	1	2	1	4
OG0004760	0	1	1	2	4
OG0004761	0	1	1	2	4
OG0004762	0	1	1	2	4
OG0004763	0	0	4	0	4
OG0004764	0	0	4	0	4
OG0004765	0	0	3	1	4
OG0004766	0	0	2	2	4
OG0004767	0	0	3	1	4
OG0004768	0	0	4	0	4
OG0004769	0	0	3	1	4
OG0004770	0	0	2	2	4
OG0004771	0	0	2	2	4
OG0004772	0	0	4	0	4
OG0004773	0	0	3	1	4
OG0004774	0	0	3	1	4
OG0004775	0	0	3	1	4
OG0004776	0	0	1	3	4
OG0004777	0	0	2	2	4
OG0004778	0	0	3	1	4
OG0004779	0	0	2	2	4
OG0004780	0	0	2	2	4
OG0004781	0	0	0	4	4
OG0004782	0	0	0	4	4
OG0004783	0	0	0	4	4
OG0004784	0	0	0	4	4
OG0004785	0	0	0	4	4
OG0004786	0	0	0	4	4
OG0004787	0	0	0	4	4
OG0004788	1	0	1	1	3
OG0004789	1	1	1	0	3
OG0004790	1	1	1	0	3
OG0004791	2	1	0	0	3
OG0004792	1	2	0	0	3
OG0004793	1	0	1	1	3
OG0004794	1	1	1	0	3
OG0004795	3	0	0	0	3
OG0004796	1	1	0	1	3
OG0004797	1	1	1	0	3
OG0004798	1	1	1	0	3
OG0004799	1	1	0	1	3
OG0004800	1	1	1	0	3
OG0004801	1	1	1	0	3
OG0004802	1	1	0	1	3
OG0004803	1	1	1	0	3
OG0004804	1	1	0	1	3
OG0004805	1	1	0	1	3
OG0004806	1	1	1	0	3
OG0004807	1	1	0	1	3
OG0004808	1	1	1	0	3
OG0004809	1	1	1	0	3
OG0004810	1	1	0	1	3
OG0004811	2	1	0	0	3
OG0004812	1	1	1	0	3
OG0004813	1	1	0	1	3
OG0004814	1	1	1	0	3
OG0004815	1	1	1	0	3
OG0004816	1	1	1	0	3
OG0004817	1	1	1	0	3
OG0004818	2	1	0	0	3
OG0004819	1	1	0	1	3
OG0004820	1	1	1	0	3
OG0004821	1	1	0	1	3
OG0004822	1	1	1	0	3
OG0004823	1	1	1	0	3
OG0004824	1	1	0	1	3
OG0004825	1	1	1	0	3
OG0004826	1	1	1	0	3
OG0004827	1	1	1	0	3
OG0004828	2	1	0	0	3
OG0004829	1	1	0	1	3
OG0004830	1	1	1	0	3
OG0004831	1	1	1	0	3
OG0004832	1	1	1	0	3
OG0004833	1	1	0	1	3
OG0004834	1	1	0	1	3
OG0004835	1	1	0	1	3
OG0004836	1	1	1	0	3
OG0004837	1	1	1	0	3
OG0004838	1	1	1	0	3
OG0004839	1	1	0	1	3
OG0004840	1	1	1	0	3
OG0004841	1	1	0	1	3
OG0004842	1	1	0	1	3
OG0004843	1	1	0	1	3
OG0004844	1	1	1	0	3
OG0004845	1	1	0	1	3
OG0004846	3	0	0	0	3
OG0004847	1	1	1	0	3
OG0004848	1	1	1	0	3
OG0004849	1	1	0	1	3
OG0004850	1	1	0	1	3
OG0004851	1	1	0	1	3
OG0004852	1	1	0	1	3
OG0004853	1	1	0	1	3
OG0004854	1	1	1	0	3
OG0004855	1	1	0	1	3
OG0004856	1	1	1	0	3
OG0004857	1	1	0	1	3
OG0004858	2	1	0	0	3
OG0004859	1	1	0	1	3
OG0004860	1	1	1	0	3
OG0004861	1	1	1	0	3
OG0004862	1	1	0	1	3
OG0004863	1	1	1	0	3
OG0004864	1	1	1	0	3
OG0004865	1	1	0	1	3
OG0004866	1	1	0	1	3
OG0004867	1	1	1	0	3
OG0004868	1	1	1	0	3
OG0004869	1	1	1	0	3
OG0004870	1	1	1	0	3
OG0004871	1	1	0	1	3
OG0004872	1	1	0	1	3
OG0004873	1	1	1	0	3
OG0004874	1	1	0	1	3
OG0004875	1	1	1	0	3
OG0004876	1	1	1	0	3
OG0004877	1	1	0	1	3
OG0004878	1	1	0	1	3
OG0004879	1	0	1	1	3
OG0004880	1	1	1	0	3
OG0004881	1	1	1	0	3
OG0004882	1	1	0	1	3
OG0004883	1	1	0	1	3
OG0004884	1	1	0	1	3
OG0004885	1	1	1	0	3
OG0004886	1	0	1	1	3
OG0004887	1	0	1	1	3
OG0004888	1	1	0	1	3
OG0004889	1	1	1	0	3
OG0004890	1	1	0	1	3
OG0004891	1	1	1	0	3
OG0004892	1	1	1	0	3
OG0004893	1	1	0	1	3
OG0004894	1	1	0	1	3
OG0004895	1	1	0	1	3
OG0004896	1	0	1	1	3
OG0004897	1	1	0	1	3
OG0004898	1	1	0	1	3
OG0004899	1	1	1	0	3
OG0004900	1	1	0	1	3
OG0004901	1	1	0	1	3
OG0004902	3	0	0	0	3
OG0004903	1	1	1	0	3
OG0004904	1	1	1	0	3
OG0004905	1	1	1	0	3
OG0004906	1	1	1	0	3
OG0004907	1	1	0	1	3
OG0004908	1	1	1	0	3
OG0004909	1	1	1	0	3
OG0004910	2	1	0	0	3
OG0004911	1	1	1	0	3
OG0004912	1	1	0	1	3
OG0004913	1	1	1	0	3
OG0004914	1	1	1	0	3
OG0004915	1	1	1	0	3
OG0004916	1	1	1	0	3
OG0004917	1	0	1	1	3
OG0004918	1	1	1	0	3
OG0004919	3	0	0	0	3
OG0004920	1	0	1	1	3
OG0004921	2	0	0	1	3
OG0004922	1	1	0	1	3
OG0004923	1	1	1	0	3
OG0004924	1	1	0	1	3
OG0004925	1	0	1	1	3
OG0004926	3	0	0	0	3
OG0004927	1	1	1	0	3
OG0004928	1	1	0	1	3
OG0004929	1	1	0	1	3
OG0004930	1	1	1	0	3
OG0004931	1	1	0	1	3
OG0004932	1	1	1	0	3
OG0004933	1	1	0	1	3
OG0004934	1	1	1	0	3
OG0004935	1	1	1	0	3
OG0004936	1	1	0	1	3
OG0004937	1	1	0	1	3
OG0004938	1	1	0	1	3
OG0004939	1	1	0	1	3
OG0004940	3	0	0	0	3
OG0004941	1	1	0	1	3
OG0004942	1	1	0	1	3
OG0004943	1	1	1	0	3
OG0004944	1	1	1	0	3
OG0004945	1	1	0	1	3
OG0004946	1	1	1	0	3
OG0004947	1	1	0	1	3
OG0004948	1	1	1	0	3
OG0004949	1	1	0	1	3
OG0004950	3	0	0	0	3
OG0004951	2	1	0	0	3
OG0004952	1	0	1	1	3
OG0004953	1	1	0	1	3
OG0004954	1	1	1	0	3
OG0004955	1	1	1	0	3
OG0004956	1	1	0	1	3
OG0004957	1	1	1	0	3
OG0004958	1	1	1	0	3
OG0004959	1	1	0	1	3
OG0004960	1	1	1	0	3
OG0004961	1	1	0	1	3
OG0004962	1	1	0	1	3
OG0004963	1	1	0	1	3
OG0004964	1	1	1	0	3
OG0004965	1	0	1	1	3
OG0004966	1	1	1	0	3
OG0004967	1	1	0	1	3
OG0004968	1	1	1	0	3
OG0004969	1	1	0	1	3
OG0004970	1	0	1	1	3
OG0004971	1	1	1	0	3
OG0004972	1	1	1	0	3
OG0004973	2	1	0	0	3
OG0004974	2	1	0	0	3
OG0004975	1	0	1	1	3
OG0004976	3	0	0	0	3
OG0004977	1	1	0	1	3
OG0004978	3	0	0	0	3
OG0004979	1	0	1	1	3
OG0004980	1	1	1	0	3
OG0004981	1	1	0	1	3
OG0004982	1	1	1	0	3
OG0004983	1	1	1	0	3
OG0004984	1	1	1	0	3
OG0004985	2	1	0	0	3
OG0004986	1	1	0	1	3
OG0004987	2	1	0	0	3
OG0004988	1	1	1	0	3
OG0004989	1	1	1	0	3
OG0004990	3	0	0	0	3
OG0004991	3	0	0	0	3
OG0004992	2	0	0	1	3
OG0004993	1	1	0	1	3
OG0004994	1	1	0	1	3
OG0004995	1	1	1	0	3
OG0004996	1	1	0	1	3
OG0004997	1	0	1	1	3
OG0004998	1	0	0	2	3
OG0004999	1	2	0	0	3
OG0005000	1	1	1	0	3
OG0005001	1	1	0	1	3
OG0005002	3	0	0	0	3
OG0005003	2	1	0	0	3
OG0005004	1	1	0	1	3
OG0005005	1	1	0	1	3
OG0005006	1	1	0	1	3
OG0005007	1	1	0	1	3
OG0005008	3	0	0	0	3
OG0005009	1	0	1	1	3
OG0005010	1	1	0	1	3
OG0005011	1	1	0	1	3
OG0005012	1	1	1	0	3
OG0005013	1	1	0	1	3
OG0005014	1	1	0	1	3
OG0005015	1	0	1	1	3
OG0005016	1	1	0	1	3
OG0005017	1	1	1	0	3
OG0005018	1	1	1	0	3
OG0005019	1	0	1	1	3
OG0005020	2	0	1	0	3
OG0005021	1	1	1	0	3
OG0005022	1	1	1	0	3
OG0005023	2	1	0	0	3
OG0005024	1	1	1	0	3
OG0005025	1	1	0	1	3
OG0005026	1	1	1	0	3
OG0005027	1	1	0	1	3
OG0005028	1	1	1	0	3
OG0005029	1	1	1	0	3
OG0005030	1	1	0	1	3
OG0005031	1	1	1	0	3
OG0005032	1	0	1	1	3
OG0005033	1	1	1	0	3
OG0005034	1	1	1	0	3
OG0005035	2	1	0	0	3
OG0005036	1	1	0	1	3
OG0005037	1	1	0	1	3
OG0005038	1	1	0	1	3
OG0005039	1	1	0	1	3
OG0005040	1	0	1	1	3
OG0005041	1	1	1	0	3
OG0005042	1	1	1	0	3
OG0005043	1	1	0	1	3
OG0005044	1	1	0	1	3
OG0005045	1	1	0	1	3
OG0005046	1	1	0	1	3
OG0005047	1	1	1	0	3
OG0005048	1	1	1	0	3
OG0005049	1	1	0	1	3
OG0005050	3	0	0	0	3
OG0005051	1	1	1	0	3
OG0005052	1	1	1	0	3
OG0005053	1	1	1	0	3
OG0005054	1	1	1	0	3
OG0005055	1	1	1	0	3
OG0005056	1	0	1	1	3
OG0005057	2	1	0	0	3
OG0005058	1	1	1	0	3
OG0005059	1	1	1	0	3
OG0005060	1	1	1	0	3
OG0005061	1	1	1	0	3
OG0005062	1	1	0	1	3
OG0005063	1	1	0	1	3
OG0005064	1	1	0	1	3
OG0005065	1	1	0	1	3
OG0005066	1	1	1	0	3
OG0005067	1	1	0	1	3
OG0005068	1	1	0	1	3
OG0005069	1	1	1	0	3
OG0005070	1	1	1	0	3
OG0005071	1	1	0	1	3
OG0005072	1	1	1	0	3
OG0005073	1	1	1	0	3
OG0005074	1	1	1	0	3
OG0005075	1	1	1	0	3
OG0005076	1	1	0	1	3
OG0005077	1	1	1	0	3
OG0005078	1	1	1	0	3
OG0005079	1	1	1	0	3
OG0005080	1	1	1	0	3
OG0005081	1	1	1	0	3
OG0005082	2	1	0	0	3
OG0005083	1	1	1	0	3
OG0005084	1	1	0	1	3
OG0005085	1	1	0	1	3
OG0005086	1	1	1	0	3
OG0005087	1	1	1	0	3
OG0005088	1	1	1	0	3
OG0005089	1	1	1	0	3
OG0005090	1	0	1	1	3
OG0005091	1	1	1	0	3
OG0005092	2	1	0	0	3
OG0005093	2	1	0	0	3
OG0005094	1	0	1	1	3
OG0005095	1	0	1	1	3
OG0005096	2	1	0	0	3
OG0005097	1	1	0	1	3
OG0005098	1	1	0	1	3
OG0005099	1	2	0	0	3
OG0005100	1	1	0	1	3
OG0005101	1	0	1	1	3
OG0005102	1	1	1	0	3
OG0005103	1	1	1	0	3
OG0005104	2	1	0	0	3
OG0005105	1	1	0	1	3
OG0005106	1	1	1	0	3
OG0005107	1	1	0	1	3
OG0005108	1	0	1	1	3
OG0005109	1	1	1	0	3
OG0005110	1	1	1	0	3
OG0005111	1	1	0	1	3
OG0005112	1	1	1	0	3
OG0005113	1	1	0	1	3
OG0005114	1	1	1	0	3
OG0005115	1	1	0	1	3
OG0005116	3	0	0	0	3
OG0005117	1	1	1	0	3
OG0005118	1	1	1	0	3
OG0005119	1	1	0	1	3
OG0005120	1	1	1	0	3
OG0005121	1	1	1	0	3
OG0005122	2	1	0	0	3
OG0005123	1	1	0	1	3
OG0005124	1	1	1	0	3
OG0005125	1	1	0	1	3
OG0005126	1	1	0	1	3
OG0005127	1	1	0	1	3
OG0005128	1	1	1	0	3
OG0005129	1	1	0	1	3
OG0005130	1	1	0	1	3
OG0005131	1	0	1	1	3
OG0005132	1	1	1	0	3
OG0005133	1	1	0	1	3
OG0005134	1	1	1	0	3
OG0005135	1	1	0	1	3
OG0005136	1	1	0	1	3
OG0005137	1	1	1	0	3
OG0005138	2	1	0	0	3
OG0005139	1	1	0	1	3
OG0005140	1	1	0	1	3
OG0005141	1	1	1	0	3
OG0005142	1	1	0	1	3
OG0005143	1	1	0	1	3
OG0005144	1	1	0	1	3
OG0005145	1	2	0	0	3
OG0005146	1	1	0	1	3
OG0005147	1	1	0	1	3
OG0005148	1	1	1	0	3
OG0005149	1	1	1	0	3
OG0005150	1	1	0	1	3
OG0005151	1	1	0	1	3
OG0005152	3	0	0	0	3
OG0005153	1	1	0	1	3
OG0005154	1	1	1	0	3
OG0005155	1	0	1	1	3
OG0005156	1	0	0	2	3
OG0005157	1	1	1	0	3
OG0005158	1	1	1	0	3
OG0005159	1	1	0	1	3
OG0005160	1	1	0	1	3
OG0005161	1	1	1	0	3
OG0005162	3	0	0	0	3
OG0005163	1	1	0	1	3
OG0005164	1	1	1	0	3
OG0005165	1	1	0	1	3
OG0005166	1	1	0	1	3
OG0005167	1	1	1	0	3
OG0005168	1	1	0	1	3
OG0005169	1	1	0	1	3
OG0005170	1	1	1	0	3
OG0005171	1	1	1	0	3
OG0005172	1	1	0	1	3
OG0005173	1	0	1	1	3
OG0005174	1	1	1	0	3
OG0005175	3	0	0	0	3
OG0005176	1	1	1	0	3
OG0005177	1	1	0	1	3
OG0005178	1	1	0	1	3
OG0005179	3	0	0	0	3
OG0005180	1	1	1	0	3
OG0005181	3	0	0	0	3
OG0005182	1	1	1	0	3
OG0005183	1	1	1	0	3
OG0005184	1	1	1	0	3
OG0005185	1	1	0	1	3
OG0005186	1	1	1	0	3
OG0005187	1	1	1	0	3
OG0005188	2	1	0	0	3
OG0005189	1	1	1	0	3
OG0005190	1	1	1	0	3
OG0005191	1	1	1	0	3
OG0005192	1	1	1	0	3
OG0005193	1	1	0	1	3
OG0005194	1	1	0	1	3
OG0005195	1	1	0	1	3
OG0005196	1	1	1	0	3
OG0005197	1	0	1	1	3
OG0005198	1	1	1	0	3
OG0005199	1	1	0	1	3
OG0005200	1	1	1	0	3
OG0005201	1	1	1	0	3
OG0005202	1	1	1	0	3
OG0005203	1	1	0	1	3
OG0005204	2	0	1	0	3
OG0005205	1	1	1	0	3
OG0005206	1	1	1	0	3
OG0005207	1	1	1	0	3
OG0005208	1	1	0	1	3
OG0005209	1	1	1	0	3
OG0005210	1	1	1	0	3
OG0005211	1	1	1	0	3
OG0005212	1	1	1	0	3
OG0005213	1	1	0	1	3
OG0005214	1	1	0	1	3
OG0005215	1	1	1	0	3
OG0005216	2	1	0	0	3
OG0005217	1	1	1	0	3
OG0005218	2	1	0	0	3
OG0005219	1	1	1	0	3
OG0005220	1	1	0	1	3
OG0005221	1	1	0	1	3
OG0005222	1	1	1	0	3
OG0005223	1	1	0	1	3
OG0005224	1	1	0	1	3
OG0005225	1	1	0	1	3
OG0005226	1	1	0	1	3
OG0005227	1	1	1	0	3
OG0005228	1	1	0	1	3
OG0005229	1	0	0	2	3
OG0005230	2	0	1	0	3
OG0005231	2	1	0	0	3
OG0005232	1	1	1	0	3
OG0005233	1	1	0	1	3
OG0005234	1	1	1	0	3
OG0005235	1	1	1	0	3
OG0005236	1	1	0	1	3
OG0005237	1	1	1	0	3
OG0005238	1	1	0	1	3
OG0005239	1	1	0	1	3
OG0005240	1	1	1	0	3
OG0005241	1	1	0	1	3
OG0005242	1	1	0	1	3
OG0005243	1	1	1	0	3
OG0005244	1	1	0	1	3
OG0005245	1	1	1	0	3
OG0005246	1	1	0	1	3
OG0005247	1	1	1	0	3
OG0005248	1	1	0	1	3
OG0005249	1	1	0	1	3
OG0005250	1	1	0	1	3
OG0005251	1	1	0	1	3
OG0005252	1	1	1	0	3
OG0005253	1	1	1	0	3
OG0005254	1	1	1	0	3
OG0005255	1	1	0	1	3
OG0005256	1	1	1	0	3
OG0005257	1	1	1	0	3
OG0005258	1	1	1	0	3
OG0005259	1	1	0	1	3
OG0005260	1	1	0	1	3
OG0005261	1	1	1	0	3
OG0005262	1	1	1	0	3
OG0005263	1	1	1	0	3
OG0005264	1	1	1	0	3
OG0005265	1	1	1	0	3
OG0005266	1	1	1	0	3
OG0005267	2	0	1	0	3
OG0005268	1	1	1	0	3
OG0005269	1	1	1	0	3
OG0005270	1	1	0	1	3
OG0005271	1	1	0	1	3
OG0005272	2	1	0	0	3
OG0005273	1	0	1	1	3
OG0005274	1	1	0	1	3
OG0005275	2	1	0	0	3
OG0005276	1	0	1	1	3
OG0005277	1	1	1	0	3
OG0005278	1	0	1	1	3
OG0005279	1	1	1	0	3
OG0005280	1	1	1	0	3
OG0005281	1	1	1	0	3
OG0005282	1	1	1	0	3
OG0005283	1	1	1	0	3
OG0005284	1	0	1	1	3
OG0005285	1	1	1	0	3
OG0005286	1	1	1	0	3
OG0005287	1	1	1	0	3
OG0005288	1	1	1	0	3
OG0005289	1	1	1	0	3
OG0005290	1	1	1	0	3
OG0005291	1	1	1	0	3
OG0005292	1	1	0	1	3
OG0005293	1	1	1	0	3
OG0005294	1	0	1	1	3
OG0005295	1	1	0	1	3
OG0005296	2	1	0	0	3
OG0005297	1	0	1	1	3
OG0005298	1	1	0	1	3
OG0005299	2	1	0	0	3
OG0005300	1	0	1	1	3
OG0005301	1	1	0	1	3
OG0005302	1	1	1	0	3
OG0005303	1	1	1	0	3
OG0005304	1	1	0	1	3
OG0005305	1	1	1	0	3
OG0005306	1	1	1	0	3
OG0005307	2	1	0	0	3
OG0005308	3	0	0	0	3
OG0005309	1	1	0	1	3
OG0005310	1	1	1	0	3
OG0005311	1	1	0	1	3
OG0005312	3	0	0	0	3
OG0005313	1	1	0	1	3
OG0005314	1	1	1	0	3
OG0005315	1	1	1	0	3
OG0005316	1	0	1	1	3
OG0005317	2	1	0	0	3
OG0005318	1	1	1	0	3
OG0005319	1	0	1	1	3
OG0005320	1	1	0	1	3
OG0005321	1	1	1	0	3
OG0005322	1	1	1	0	3
OG0005323	1	1	0	1	3
OG0005324	1	1	1	0	3
OG0005325	1	1	1	0	3
OG0005326	3	0	0	0	3
OG0005327	1	0	0	2	3
OG0005328	1	1	1	0	3
OG0005329	2	1	0	0	3
OG0005330	1	1	1	0	3
OG0005331	1	1	0	1	3
OG0005332	1	1	1	0	3
OG0005333	1	1	1	0	3
OG0005334	1	0	1	1	3
OG0005335	1	1	1	0	3
OG0005336	1	1	1	0	3
OG0005337	1	0	0	2	3
OG0005338	1	1	0	1	3
OG0005339	1	1	1	0	3
OG0005340	1	1	1	0	3
OG0005341	1	1	1	0	3
OG0005342	1	1	1	0	3
OG0005343	1	1	1	0	3
OG0005344	1	1	1	0	3
OG0005345	1	1	1	0	3
OG0005346	1	1	0	1	3
OG0005347	1	1	1	0	3
OG0005348	1	1	1	0	3
OG0005349	1	1	1	0	3
OG0005350	1	0	1	1	3
OG0005351	1	1	1	0	3
OG0005352	1	1	1	0	3
OG0005353	1	1	0	1	3
OG0005354	3	0	0	0	3
OG0005355	1	1	0	1	3
OG0005356	1	1	1	0	3
OG0005357	1	1	1	0	3
OG0005358	1	0	1	1	3
OG0005359	1	0	1	1	3
OG0005360	1	0	1	1	3
OG0005361	2	1	0	0	3
OG0005362	1	1	0	1	3
OG0005363	1	1	1	0	3
OG0005364	1	0	1	1	3
OG0005365	2	1	0	0	3
OG0005366	1	1	1	0	3
OG0005367	1	1	0	1	3
OG0005368	1	1	1	0	3
OG0005369	1	0	1	1	3
OG0005370	2	1	0	0	3
OG0005371	1	1	0	1	3
OG0005372	1	1	0	1	3
OG0005373	1	1	1	0	3
OG0005374	1	0	1	1	3
OG0005375	1	1	1	0	3
OG0005376	1	1	1	0	3
OG0005377	1	1	0	1	3
OG0005378	1	1	1	0	3
OG0005379	1	1	0	1	3
OG0005380	1	1	1	0	3
OG0005381	1	1	1	0	3
OG0005382	1	1	0	1	3
OG0005383	1	1	1	0	3
OG0005384	1	0	1	1	3
OG0005385	1	0	1	1	3
OG0005386	1	1	1	0	3
OG0005387	1	1	0	1	3
OG0005388	1	1	1	0	3
OG0005389	1	1	0	1	3
OG0005390	1	1	0	1	3
OG0005391	1	1	0	1	3
OG0005392	2	1	0	0	3
OG0005393	1	1	0	1	3
OG0005394	1	1	1	0	3
OG0005395	3	0	0	0	3
OG0005396	2	0	0	1	3
OG0005397	1	1	0	1	3
OG0005398	1	1	1	0	3
OG0005399	1	0	1	1	3
OG0005400	1	1	1	0	3
OG0005401	1	1	1	0	3
OG0005402	1	1	0	1	3
OG0005403	1	1	0	1	3
OG0005404	1	1	0	1	3
OG0005405	1	1	1	0	3
OG0005406	1	1	1	0	3
OG0005407	1	0	1	1	3
OG0005408	1	1	0	1	3
OG0005409	1	1	1	0	3
OG0005410	1	1	1	0	3
OG0005411	1	1	1	0	3
OG0005412	1	2	0	0	3
OG0005413	1	1	0	1	3
OG0005414	1	1	1	0	3
OG0005415	1	1	1	0	3
OG0005416	1	0	1	1	3
OG0005417	1	1	0	1	3
OG0005418	1	1	1	0	3
OG0005419	1	1	1	0	3
OG0005420	1	0	1	1	3
OG0005421	2	1	0	0	3
OG0005422	2	1	0	0	3
OG0005423	1	1	1	0	3
OG0005424	1	1	1	0	3
OG0005425	3	0	0	0	3
OG0005426	1	1	0	1	3
OG0005427	1	1	1	0	3
OG0005428	1	1	0	1	3
OG0005429	1	1	0	1	3
OG0005430	1	1	1	0	3
OG0005431	1	1	0	1	3
OG0005432	1	0	1	1	3
OG0005433	1	1	1	0	3
OG0005434	1	1	1	0	3
OG0005435	1	1	0	1	3
OG0005436	1	0	1	1	3
OG0005437	1	1	0	1	3
OG0005438	1	1	1	0	3
OG0005439	1	1	0	1	3
OG0005440	1	1	1	0	3
OG0005441	1	1	1	0	3
OG0005442	1	1	1	0	3
OG0005443	3	0	0	0	3
OG0005444	1	0	1	1	3
OG0005445	1	1	0	1	3
OG0005446	1	1	0	1	3
OG0005447	1	1	1	0	3
OG0005448	2	1	0	0	3
OG0005449	1	1	0	1	3
OG0005450	1	1	0	1	3
OG0005451	1	1	0	1	3
OG0005452	1	0	1	1	3
OG0005453	1	1	1	0	3
OG0005454	1	1	1	0	3
OG0005455	1	1	1	0	3
OG0005456	1	1	1	0	3
OG0005457	1	0	1	1	3
OG0005458	1	1	1	0	3
OG0005459	1	1	1	0	3
OG0005460	1	1	1	0	3
OG0005461	1	1	0	1	3
OG0005462	1	1	1	0	3
OG0005463	1	1	1	0	3
OG0005464	1	1	0	1	3
OG0005465	1	1	0	1	3
OG0005466	1	1	1	0	3
OG0005467	1	1	1	0	3
OG0005468	1	1	1	0	3
OG0005469	1	1	0	1	3
OG0005470	1	1	0	1	3
OG0005471	1	1	1	0	3
OG0005472	1	1	0	1	3
OG0005473	1	1	1	0	3
OG0005474	1	1	1	0	3
OG0005475	1	1	0	1	3
OG0005476	1	1	0	1	3
OG0005477	1	1	0	1	3
OG0005478	1	1	1	0	3
OG0005479	1	1	1	0	3
OG0005480	1	1	0	1	3
OG0005481	1	1	1	0	3
OG0005482	1	1	1	0	3
OG0005483	1	1	1	0	3
OG0005484	1	0	1	1	3
OG0005485	1	1	1	0	3
OG0005486	1	1	0	1	3
OG0005487	1	1	0	1	3
OG0005488	1	1	1	0	3
OG0005489	1	1	1	0	3
OG0005490	1	1	0	1	3
OG0005491	1	1	1	0	3
OG0005492	1	0	1	1	3
OG0005493	1	1	1	0	3
OG0005494	1	1	0	1	3
OG0005495	1	1	1	0	3
OG0005496	1	0	1	1	3
OG0005497	1	1	0	1	3
OG0005498	1	1	1	0	3
OG0005499	1	1	0	1	3
OG0005500	1	1	1	0	3
OG0005501	1	1	1	0	3
OG0005502	1	1	0	1	3
OG0005503	1	1	0	1	3
OG0005504	1	1	0	1	3
OG0005505	1	1	1	0	3
OG0005506	1	1	1	0	3
OG0005507	1	1	0	1	3
OG0005508	1	1	1	0	3
OG0005509	1	1	0	1	3
OG0005510	1	1	1	0	3
OG0005511	1	1	0	1	3
OG0005512	1	1	1	0	3
OG0005513	1	1	1	0	3
OG0005514	1	1	0	1	3
OG0005515	1	1	0	1	3
OG0005516	1	1	0	1	3
OG0005517	1	1	1	0	3
OG0005518	1	1	1	0	3
OG0005519	1	1	1	0	3
OG0005520	1	1	1	0	3
OG0005521	1	1	1	0	3
OG0005522	1	1	1	0	3
OG0005523	1	1	1	0	3
OG0005524	1	1	1	0	3
OG0005525	1	1	0	1	3
OG0005526	1	1	1	0	3
OG0005527	1	1	0	1	3
OG0005528	1	1	0	1	3
OG0005529	1	1	0	1	3
OG0005530	1	1	0	1	3
OG0005531	1	1	0	1	3
OG0005532	1	1	1	0	3
OG0005533	1	1	1	0	3
OG0005534	1	1	1	0	3
OG0005535	1	1	1	0	3
OG0005536	1	1	1	0	3
OG0005537	1	0	1	1	3
OG0005538	1	1	0	1	3
OG0005539	1	1	1	0	3
OG0005540	1	1	0	1	3
OG0005541	1	1	1	0	3
OG0005542	1	1	0	1	3
OG0005543	1	1	1	0	3
OG0005544	1	1	1	0	3
OG0005545	1	1	0	1	3
OG0005546	1	1	1	0	3
OG0005547	1	1	0	1	3
OG0005548	1	1	1	0	3
OG0005549	1	1	1	0	3
OG0005550	1	1	0	1	3
OG0005551	1	1	0	1	3
OG0005552	1	1	0	1	3
OG0005553	1	1	0	1	3
OG0005554	1	1	1	0	3
OG0005555	1	1	1	0	3
OG0005556	1	1	0	1	3
OG0005557	1	1	1	0	3
OG0005558	1	1	1	0	3
OG0005559	1	1	1	0	3
OG0005560	1	1	0	1	3
OG0005561	1	1	1	0	3
OG0005562	1	1	0	1	3
OG0005563	1	1	0	1	3
OG0005564	1	1	1	0	3
OG0005565	1	1	1	0	3
OG0005566	1	1	1	0	3
OG0005567	1	1	1	0	3
OG0005568	1	1	0	1	3
OG0005569	1	1	1	0	3
OG0005570	1	1	1	0	3
OG0005571	1	1	1	0	3
OG0005572	1	1	1	0	3
OG0005573	1	1	1	0	3
OG0005574	1	1	1	0	3
OG0005575	1	1	0	1	3
OG0005576	1	1	1	0	3
OG0005577	1	1	1	0	3
OG0005578	1	1	1	0	3
OG0005579	1	1	1	0	3
OG0005580	1	1	1	0	3
OG0005581	1	1	0	1	3
OG0005582	1	1	0	1	3
OG0005583	1	1	0	1	3
OG0005584	1	1	0	1	3
OG0005585	1	1	0	1	3
OG0005586	1	1	0	1	3
OG0005587	1	1	1	0	3
OG0005588	1	1	1	0	3
OG0005589	1	1	0	1	3
OG0005590	1	1	0	1	3
OG0005591	1	1	1	0	3
OG0005592	1	1	1	0	3
OG0005593	1	1	1	0	3
OG0005594	1	1	1	0	3
OG0005595	1	1	0	1	3
OG0005596	1	0	1	1	3
OG0005597	1	1	1	0	3
OG0005598	1	1	1	0	3
OG0005599	1	1	0	1	3
OG0005600	1	1	1	0	3
OG0005601	1	1	0	1	3
OG0005602	1	1	0	1	3
OG0005603	1	1	0	1	3
OG0005604	1	1	0	1	3
OG0005605	1	1	1	0	3
OG0005606	1	1	1	0	3
OG0005607	1	1	1	0	3
OG0005608	1	1	0	1	3
OG0005609	1	1	1	0	3
OG0005610	1	1	0	1	3
OG0005611	1	1	0	1	3
OG0005612	1	1	0	1	3
OG0005613	1	1	1	0	3
OG0005614	1	1	0	1	3
OG0005615	1	1	0	1	3
OG0005616	1	1	0	1	3
OG0005617	1	1	0	1	3
OG0005618	1	1	1	0	3
OG0005619	1	1	0	1	3
OG0005620	1	1	0	1	3
OG0005621	1	1	1	0	3
OG0005622	1	1	1	0	3
OG0005623	1	1	0	1	3
OG0005624	1	1	0	1	3
OG0005625	1	1	1	0	3
OG0005626	1	1	0	1	3
OG0005627	1	1	1	0	3
OG0005628	1	1	1	0	3
OG0005629	1	1	1	0	3
OG0005630	1	1	1	0	3
OG0005631	1	1	1	0	3
OG0005632	1	0	1	1	3
OG0005633	1	1	0	1	3
OG0005634	1	1	1	0	3
OG0005635	1	1	0	1	3
OG0005636	1	1	0	1	3
OG0005637	1	1	1	0	3
OG0005638	1	2	0	0	3
OG0005639	1	1	0	1	3
OG0005640	1	1	1	0	3
OG0005641	1	1	0	1	3
OG0005642	1	1	0	1	3
OG0005643	1	1	0	1	3
OG0005644	1	1	0	1	3
OG0005645	1	1	0	1	3
OG0005646	1	1	1	0	3
OG0005647	1	1	1	0	3
OG0005648	1	1	1	0	3
OG0005649	1	1	0	1	3
OG0005650	1	0	1	1	3
OG0005651	1	1	0	1	3
OG0005652	1	1	1	0	3
OG0005653	1	1	1	0	3
OG0005654	1	1	1	0	3
OG0005655	1	1	1	0	3
OG0005656	1	1	1	0	3
OG0005657	1	1	1	0	3
OG0005658	1	1	0	1	3
OG0005659	1	1	1	0	3
OG0005660	1	1	1	0	3
OG0005661	1	1	1	0	3
OG0005662	1	1	0	1	3
OG0005663	1	1	0	1	3
OG0005664	1	1	0	1	3
OG0005665	1	1	1	0	3
OG0005666	1	1	1	0	3
OG0005667	1	1	1	0	3
OG0005668	1	1	1	0	3
OG0005669	1	1	1	0	3
OG0005670	1	1	0	1	3
OG0005671	1	1	0	1	3
OG0005672	1	1	1	0	3
OG0005673	1	1	1	0	3
OG0005674	1	1	1	0	3
OG0005675	1	1	0	1	3
OG0005676	1	1	1	0	3
OG0005677	1	1	1	0	3
OG0005678	1	1	1	0	3
OG0005679	1	1	1	0	3
OG0005680	1	0	1	1	3
OG0005681	1	1	0	1	3
OG0005682	1	1	0	1	3
OG0005683	1	1	0	1	3
OG0005684	1	1	0	1	3
OG0005685	1	1	0	1	3
OG0005686	1	0	1	1	3
OG0005687	1	1	1	0	3
OG0005688	0	1	1	1	3
OG0005689	0	2	1	0	3
OG0005690	0	1	1	1	3
OG0005691	0	1	1	1	3
OG0005692	0	1	1	1	3
OG0005693	0	1	2	0	3
OG0005694	0	1	1	1	3
OG0005695	0	1	1	1	3
OG0005696	0	1	1	1	3
OG0005697	0	2	0	1	3
OG0005698	0	1	1	1	3
OG0005699	0	1	1	1	3
OG0005700	0	1	1	1	3
OG0005701	0	3	0	0	3
OG0005702	0	1	1	1	3
OG0005703	0	1	1	1	3
OG0005704	0	1	1	1	3
OG0005705	0	1	1	1	3
OG0005706	0	2	0	1	3
OG0005707	0	1	1	1	3
OG0005708	0	3	0	0	3
OG0005709	0	1	2	0	3
OG0005710	0	1	1	1	3
OG0005711	0	1	1	1	3
OG0005712	0	1	1	1	3
OG0005713	0	1	2	0	3
OG0005714	0	1	1	1	3
OG0005715	0	1	1	1	3
OG0005716	0	1	1	1	3
OG0005717	0	1	1	1	3
OG0005718	0	1	1	1	3
OG0005719	0	2	1	0	3
OG0005720	0	1	1	1	3
OG0005721	0	1	1	1	3
OG0005722	0	1	1	1	3
OG0005723	0	1	1	1	3
OG0005724	0	2	1	0	3
OG0005725	0	1	1	1	3
OG0005726	0	1	1	1	3
OG0005727	0	1	0	2	3
OG0005728	0	1	1	1	3
OG0005729	0	1	1	1	3
OG0005730	0	1	0	2	3
OG0005731	0	2	0	1	3
OG0005732	0	1	1	1	3
OG0005733	0	1	2	0	3
OG0005734	0	1	1	1	3
OG0005735	0	1	1	1	3
OG0005736	0	1	1	1	3
OG0005737	0	2	1	0	3
OG0005738	0	1	1	1	3
OG0005739	0	1	1	1	3
OG0005740	0	2	1	0	3
OG0005741	0	2	0	1	3
OG0005742	0	1	1	1	3
OG0005743	0	1	0	2	3
OG0005744	0	1	1	1	3
OG0005745	0	1	1	1	3
OG0005746	0	1	1	1	3
OG0005747	0	1	0	2	3
OG0005748	0	2	0	1	3
OG0005749	0	1	1	1	3
OG0005750	0	2	1	0	3
OG0005751	0	1	1	1	3
OG0005752	0	2	0	1	3
OG0005753	0	1	1	1	3
OG0005754	0	1	1	1	3
OG0005755	0	1	1	1	3
OG0005756	0	1	1	1	3
OG0005757	0	1	1	1	3
OG0005758	0	1	1	1	3
OG0005759	0	1	1	1	3
OG0005760	0	1	0	2	3
OG0005761	0	1	1	1	3
OG0005762	0	1	1	1	3
OG0005763	0	1	1	1	3
OG0005764	0	1	1	1	3
OG0005765	0	1	1	1	3
OG0005766	0	1	1	1	3
OG0005767	0	1	1	1	3
OG0005768	0	1	1	1	3
OG0005769	0	1	1	1	3
OG0005770	0	1	1	1	3
OG0005771	0	1	1	1	3
OG0005772	0	1	2	0	3
OG0005773	0	1	1	1	3
OG0005774	0	1	1	1	3
OG0005775	0	2	0	1	3
OG0005776	0	1	1	1	3
OG0005777	0	1	1	1	3
OG0005778	0	1	1	1	3
OG0005779	0	1	1	1	3
OG0005780	0	1	1	1	3
OG0005781	0	1	2	0	3
OG0005782	0	1	1	1	3
OG0005783	0	1	1	1	3
OG0005784	0	1	1	1	3
OG0005785	0	1	2	0	3
OG0005786	0	1	1	1	3
OG0005787	0	1	1	1	3
OG0005788	0	1	1	1	3
OG0005789	0	1	1	1	3
OG0005790	0	1	1	1	3
OG0005791	0	1	1	1	3
OG0005792	0	1	1	1	3
OG0005793	0	1	1	1	3
OG0005794	0	1	1	1	3
OG0005795	0	1	1	1	3
OG0005796	0	2	1	0	3
OG0005797	0	1	1	1	3
OG0005798	0	1	1	1	3
OG0005799	0	1	1	1	3
OG0005800	0	1	1	1	3
OG0005801	0	3	0	0	3
OG0005802	0	1	1	1	3
OG0005803	0	1	1	1	3
OG0005804	0	1	1	1	3
OG0005805	0	1	1	1	3
OG0005806	0	1	1	1	3
OG0005807	0	3	0	0	3
OG0005808	0	1	1	1	3
OG0005809	0	1	1	1	3
OG0005810	0	1	1	1	3
OG0005811	0	1	1	1	3
OG0005812	0	3	0	0	3
OG0005813	0	1	0	2	3
OG0005814	0	1	1	1	3
OG0005815	0	3	0	0	3
OG0005816	0	1	0	2	3
OG0005817	0	1	1	1	3
OG0005818	0	1	1	1	3
OG0005819	0	3	0	0	3
OG0005820	0	1	1	1	3
OG0005821	0	1	1	1	3
OG0005822	0	1	1	1	3
OG0005823	0	1	1	1	3
OG0005824	0	1	1	1	3
OG0005825	0	1	1	1	3
OG0005826	0	1	1	1	3
OG0005827	0	1	2	0	3
OG0005828	0	1	1	1	3
OG0005829	0	1	1	1	3
OG0005830	0	1	1	1	3
OG0005831	0	1	1	1	3
OG0005832	0	2	0	1	3
OG0005833	0	1	1	1	3
OG0005834	0	1	1	1	3
OG0005835	0	1	1	1	3
OG0005836	0	1	1	1	3
OG0005837	0	1	1	1	3
OG0005838	0	1	1	1	3
OG0005839	0	1	1	1	3
OG0005840	0	1	1	1	3
OG0005841	0	1	1	1	3
OG0005842	0	1	1	1	3
OG0005843	0	2	1	0	3
OG0005844	0	1	1	1	3
OG0005845	0	1	0	2	3
OG0005846	0	1	0	2	3
OG0005847	0	1	1	1	3
OG0005848	0	1	1	1	3
OG0005849	0	1	1	1	3
OG0005850	0	1	1	1	3
OG0005851	0	1	1	1	3
OG0005852	0	1	1	1	3
OG0005853	0	1	1	1	3
OG0005854	0	1	1	1	3
OG0005855	0	1	1	1	3
OG0005856	0	1	1	1	3
OG0005857	0	1	1	1	3
OG0005858	0	1	1	1	3
OG0005859	0	3	0	0	3
OG0005860	0	3	0	0	3
OG0005861	0	3	0	0	3
OG0005862	0	3	0	0	3
OG0005863	0	1	1	1	3
OG0005864	0	1	1	1	3
OG0005865	0	2	0	1	3
OG0005866	0	1	1	1	3
OG0005867	0	1	1	1	3
OG0005868	0	1	1	1	3
OG0005869	0	1	1	1	3
OG0005870	0	1	1	1	3
OG0005871	0	2	1	0	3
OG0005872	0	1	1	1	3
OG0005873	0	1	1	1	3
OG0005874	0	1	1	1	3
OG0005875	0	1	1	1	3
OG0005876	0	1	1	1	3
OG0005877	0	1	1	1	3
OG0005878	0	1	1	1	3
OG0005879	0	1	1	1	3
OG0005880	0	1	1	1	3
OG0005881	0	1	1	1	3
OG0005882	0	1	1	1	3
OG0005883	0	1	1	1	3
OG0005884	0	3	0	0	3
OG0005885	0	1	1	1	3
OG0005886	0	1	1	1	3
OG0005887	0	1	1	1	3
OG0005888	0	1	1	1	3
OG0005889	0	1	1	1	3
OG0005890	0	1	1	1	3
OG0005891	0	1	1	1	3
OG0005892	0	3	0	0	3
OG0005893	0	2	0	1	3
OG0005894	0	1	1	1	3
OG0005895	0	1	1	1	3
OG0005896	0	1	1	1	3
OG0005897	0	1	1	1	3
OG0005898	0	1	1	1	3
OG0005899	0	1	1	1	3
OG0005900	0	1	1	1	3
OG0005901	0	1	1	1	3
OG0005902	0	1	1	1	3
OG0005903	0	1	1	1	3
OG0005904	0	1	1	1	3
OG0005905	0	1	1	1	3
OG0005906	0	1	1	1	3
OG0005907	0	1	1	1	3
OG0005908	0	1	1	1	3
OG0005909	0	1	1	1	3
OG0005910	0	1	1	1	3
OG0005911	0	1	1	1	3
OG0005912	0	1	1	1	3
OG0005913	0	1	1	1	3
OG0005914	0	1	1	1	3
OG0005915	0	1	2	0	3
OG0005916	0	1	1	1	3
OG0005917	0	1	1	1	3
OG0005918	0	1	1	1	3
OG0005919	0	1	2	0	3
OG0005920	0	1	1	1	3
OG0005921	0	1	1	1	3
OG0005922	0	1	1	1	3
OG0005923	0	1	1	1	3
OG0005924	0	1	1	1	3
OG0005925	0	1	1	1	3
OG0005926	0	2	0	1	3
OG0005927	0	1	1	1	3
OG0005928	0	1	1	1	3
OG0005929	0	1	1	1	3
OG0005930	0	1	1	1	3
OG0005931	0	1	1	1	3
OG0005932	0	1	1	1	3
OG0005933	0	1	1	1	3
OG0005934	0	1	1	1	3
OG0005935	0	1	1	1	3
OG0005936	0	1	2	0	3
OG0005937	0	1	1	1	3
OG0005938	0	1	1	1	3
OG0005939	0	1	1	1	3
OG0005940	0	2	0	1	3
OG0005941	0	1	1	1	3
OG0005942	0	1	1	1	3
OG0005943	0	1	1	1	3
OG0005944	0	1	0	2	3
OG0005945	0	1	2	0	3
OG0005946	0	1	1	1	3
OG0005947	0	1	1	1	3
OG0005948	0	1	1	1	3
OG0005949	0	2	0	1	3
OG0005950	0	1	1	1	3
OG0005951	0	1	1	1	3
OG0005952	0	1	1	1	3
OG0005953	0	1	1	1	3
OG0005954	0	1	1	1	3
OG0005955	0	2	0	1	3
OG0005956	0	1	1	1	3
OG0005957	0	1	1	1	3
OG0005958	0	1	1	1	3
OG0005959	0	1	1	1	3
OG0005960	0	1	1	1	3
OG0005961	0	1	1	1	3
OG0005962	0	1	1	1	3
OG0005963	0	1	1	1	3
OG0005964	0	1	1	1	3
OG0005965	0	1	1	1	3
OG0005966	0	1	1	1	3
OG0005967	0	2	1	0	3
OG0005968	0	1	1	1	3
OG0005969	0	1	1	1	3
OG0005970	0	1	2	0	3
OG0005971	0	1	1	1	3
OG0005972	0	1	1	1	3
OG0005973	0	1	1	1	3
OG0005974	0	2	0	1	3
OG0005975	0	1	1	1	3
OG0005976	0	1	1	1	3
OG0005977	0	1	1	1	3
OG0005978	0	1	1	1	3
OG0005979	0	1	1	1	3
OG0005980	0	1	1	1	3
OG0005981	0	1	1	1	3
OG0005982	0	1	0	2	3
OG0005983	0	1	1	1	3
OG0005984	0	1	1	1	3
OG0005985	0	1	1	1	3
OG0005986	0	1	1	1	3
OG0005987	0	2	0	1	3
OG0005988	0	1	1	1	3
OG0005989	0	1	1	1	3
OG0005990	0	1	1	1	3
OG0005991	0	1	1	1	3
OG0005992	0	1	2	0	3
OG0005993	0	1	1	1	3
OG0005994	0	1	0	2	3
OG0005995	0	1	1	1	3
OG0005996	0	1	1	1	3
OG0005997	0	1	1	1	3
OG0005998	0	1	1	1	3
OG0005999	0	1	1	1	3
OG0006000	0	1	1	1	3
OG0006001	0	1	1	1	3
OG0006002	0	1	2	0	3
OG0006003	0	1	2	0	3
OG0006004	0	1	1	1	3
OG0006005	0	1	1	1	3
OG0006006	0	1	1	1	3
OG0006007	0	1	1	1	3
OG0006008	0	1	1	1	3
OG0006009	0	1	1	1	3
OG0006010	0	2	1	0	3
OG0006011	0	1	2	0	3
OG0006012	0	1	1	1	3
OG0006013	0	1	1	1	3
OG0006014	0	1	1	1	3
OG0006015	0	1	1	1	3
OG0006016	0	1	1	1	3
OG0006017	0	1	1	1	3
OG0006018	0	1	1	1	3
OG0006019	0	2	1	0	3
OG0006020	0	1	1	1	3
OG0006021	0	1	1	1	3
OG0006022	0	1	1	1	3
OG0006023	0	1	1	1	3
OG0006024	0	1	1	1	3
OG0006025	0	1	1	1	3
OG0006026	0	1	1	1	3
OG0006027	0	1	1	1	3
OG0006028	0	1	1	1	3
OG0006029	0	1	1	1	3
OG0006030	0	1	1	1	3
OG0006031	0	1	2	0	3
OG0006032	0	3	0	0	3
OG0006033	0	1	0	2	3
OG0006034	0	1	1	1	3
OG0006035	0	1	1	1	3
OG0006036	0	1	1	1	3
OG0006037	0	3	0	0	3
OG0006038	0	1	1	1	3
OG0006039	0	1	1	1	3
OG0006040	0	3	0	0	3
OG0006041	0	1	1	1	3
OG0006042	0	1	1	1	3
OG0006043	0	1	1	1	3
OG0006044	0	1	1	1	3
OG0006045	0	1	1	1	3
OG0006046	0	1	1	1	3
OG0006047	0	1	1	1	3
OG0006048	0	1	1	1	3
OG0006049	0	1	1	1	3
OG0006050	0	1	1	1	3
OG0006051	0	1	1	1	3
OG0006052	0	1	1	1	3
OG0006053	0	1	1	1	3
OG0006054	0	1	1	1	3
OG0006055	0	1	0	2	3
OG0006056	0	1	1	1	3
OG0006057	0	1	1	1	3
OG0006058	0	1	1	1	3
OG0006059	0	1	1	1	3
OG0006060	0	1	1	1	3
OG0006061	0	1	1	1	3
OG0006062	0	1	1	1	3
OG0006063	0	1	1	1	3
OG0006064	0	1	1	1	3
OG0006065	0	2	1	0	3
OG0006066	0	1	1	1	3
OG0006067	0	1	2	0	3
OG0006068	0	1	1	1	3
OG0006069	0	1	1	1	3
OG0006070	0	1	1	1	3
OG0006071	0	2	0	1	3
OG0006072	0	1	1	1	3
OG0006073	0	1	1	1	3
OG0006074	0	1	2	0	3
OG0006075	0	1	1	1	3
OG0006076	0	1	1	1	3
OG0006077	0	1	1	1	3
OG0006078	0	1	2	0	3
OG0006079	0	1	1	1	3
OG0006080	0	1	1	1	3
OG0006081	0	1	1	1	3
OG0006082	0	1	1	1	3
OG0006083	0	1	1	1	3
OG0006084	0	1	1	1	3
OG0006085	0	1	1	1	3
OG0006086	0	1	1	1	3
OG0006087	0	1	0	2	3
OG0006088	0	1	1	1	3
OG0006089	0	1	1	1	3
OG0006090	0	1	1	1	3
OG0006091	0	1	1	1	3
OG0006092	0	1	1	1	3
OG0006093	0	1	1	1	3
OG0006094	0	1	1	1	3
OG0006095	0	1	1	1	3
OG0006096	0	1	1	1	3
OG0006097	0	2	1	0	3
OG0006098	0	1	1	1	3
OG0006099	0	1	1	1	3
OG0006100	0	1	1	1	3
OG0006101	0	1	1	1	3
OG0006102	0	1	1	1	3
OG0006103	0	1	1	1	3
OG0006104	0	1	1	1	3
OG0006105	0	1	1	1	3
OG0006106	0	1	1	1	3
OG0006107	0	1	1	1	3
OG0006108	0	1	0	2	3
OG0006109	0	1	1	1	3
OG0006110	0	1	1	1	3
OG0006111	0	2	1	0	3
OG0006112	0	1	1	1	3
OG0006113	0	2	1	0	3
OG0006114	0	1	1	1	3
OG0006115	0	1	1	1	3
OG0006116	0	1	1	1	3
OG0006117	0	1	1	1	3
OG0006118	0	1	1	1	3
OG0006119	0	3	0	0	3
OG0006120	0	1	1	1	3
OG0006121	0	2	0	1	3
OG0006122	0	1	1	1	3
OG0006123	0	1	1	1	3
OG0006124	0	1	1	1	3
OG0006125	0	1	1	1	3
OG0006126	0	2	1	0	3
OG0006127	0	1	2	0	3
OG0006128	0	1	1	1	3
OG0006129	0	1	1	1	3
OG0006130	0	2	1	0	3
OG0006131	0	1	1	1	3
OG0006132	0	1	0	2	3
OG0006133	0	1	1	1	3
OG0006134	0	1	1	1	3
OG0006135	0	1	1	1	3
OG0006136	0	1	1	1	3
OG0006137	0	2	1	0	3
OG0006138	0	1	1	1	3
OG0006139	0	1	1	1	3
OG0006140	0	1	1	1	3
OG0006141	0	1	1	1	3
OG0006142	0	1	1	1	3
OG0006143	0	1	1	1	3
OG0006144	0	2	0	1	3
OG0006145	0	1	2	0	3
OG0006146	0	1	1	1	3
OG0006147	0	1	1	1	3
OG0006148	0	1	1	1	3
OG0006149	0	1	1	1	3
OG0006150	0	1	1	1	3
OG0006151	0	1	1	1	3
OG0006152	0	1	1	1	3
OG0006153	0	1	1	1	3
OG0006154	0	1	1	1	3
OG0006155	0	1	1	1	3
OG0006156	0	3	0	0	3
OG0006157	0	1	1	1	3
OG0006158	0	1	1	1	3
OG0006159	0	2	1	0	3
OG0006160	0	1	1	1	3
OG0006161	0	1	1	1	3
OG0006162	0	1	1	1	3
OG0006163	0	1	1	1	3
OG0006164	0	1	1	1	3
OG0006165	0	1	1	1	3
OG0006166	0	1	1	1	3
OG0006167	0	1	1	1	3
OG0006168	0	1	1	1	3
OG0006169	0	1	2	0	3
OG0006170	0	1	1	1	3
OG0006171	0	1	1	1	3
OG0006172	0	1	1	1	3
OG0006173	0	1	1	1	3
OG0006174	0	1	1	1	3
OG0006175	0	1	1	1	3
OG0006176	0	1	1	1	3
OG0006177	0	1	1	1	3
OG0006178	0	1	1	1	3
OG0006179	0	1	1	1	3
OG0006180	0	1	1	1	3
OG0006181	0	1	1	1	3
OG0006182	0	1	1	1	3
OG0006183	0	1	1	1	3
OG0006184	0	1	1	1	3
OG0006185	0	1	1	1	3
OG0006186	0	1	2	0	3
OG0006187	0	1	1	1	3
OG0006188	0	1	1	1	3
OG0006189	0	1	1	1	3
OG0006190	0	1	1	1	3
OG0006191	0	1	2	0	3
OG0006192	0	1	1	1	3
OG0006193	0	1	1	1	3
OG0006194	0	2	0	1	3
OG0006195	0	1	1	1	3
OG0006196	0	1	1	1	3
OG0006197	0	1	1	1	3
OG0006198	0	2	1	0	3
OG0006199	0	1	1	1	3
OG0006200	0	1	1	1	3
OG0006201	0	2	1	0	3
OG0006202	0	1	1	1	3
OG0006203	0	1	1	1	3
OG0006204	0	1	1	1	3
OG0006205	0	1	1	1	3
OG0006206	0	1	1	1	3
OG0006207	0	1	0	2	3
OG0006208	0	1	0	2	3
OG0006209	0	1	2	0	3
OG0006210	0	1	1	1	3
OG0006211	0	1	1	1	3
OG0006212	0	1	1	1	3
OG0006213	0	1	1	1	3
OG0006214	0	1	1	1	3
OG0006215	0	1	1	1	3
OG0006216	0	1	1	1	3
OG0006217	0	1	1	1	3
OG0006218	0	1	1	1	3
OG0006219	0	1	1	1	3
OG0006220	0	1	1	1	3
OG0006221	0	1	1	1	3
OG0006222	0	1	1	1	3
OG0006223	0	1	1	1	3
OG0006224	0	1	1	1	3
OG0006225	0	1	1	1	3
OG0006226	0	1	0	2	3
OG0006227	0	1	0	2	3
OG0006228	0	1	1	1	3
OG0006229	0	1	1	1	3
OG0006230	0	1	1	1	3
OG0006231	0	1	1	1	3
OG0006232	0	1	0	2	3
OG0006233	0	1	1	1	3
OG0006234	0	1	1	1	3
OG0006235	0	1	1	1	3
OG0006236	0	1	1	1	3
OG0006237	0	1	0	2	3
OG0006238	0	1	1	1	3
OG0006239	0	1	1	1	3
OG0006240	0	1	1	1	3
OG0006241	0	1	1	1	3
OG0006242	0	1	1	1	3
OG0006243	0	2	0	1	3
OG0006244	0	1	1	1	3
OG0006245	0	1	1	1	3
OG0006246	0	1	0	2	3
OG0006247	0	1	1	1	3
OG0006248	0	1	1	1	3
OG0006249	0	1	1	1	3
OG0006250	0	1	1	1	3
OG0006251	0	2	1	0	3
OG0006252	0	1	0	2	3
OG0006253	0	1	1	1	3
OG0006254	0	1	1	1	3
OG0006255	0	1	1	1	3
OG0006256	0	2	0	1	3
OG0006257	0	1	1	1	3
OG0006258	0	1	0	2	3
OG0006259	0	1	1	1	3
OG0006260	0	1	1	1	3
OG0006261	0	1	1	1	3
OG0006262	0	1	1	1	3
OG0006263	0	1	1	1	3
OG0006264	0	1	0	2	3
OG0006265	0	1	1	1	3
OG0006266	0	1	1	1	3
OG0006267	0	1	1	1	3
OG0006268	0	1	1	1	3
OG0006269	0	2	0	1	3
OG0006270	0	1	1	1	3
OG0006271	0	1	1	1	3
OG0006272	0	1	1	1	3
OG0006273	0	1	1	1	3
OG0006274	0	1	1	1	3
OG0006275	0	1	1	1	3
OG0006276	0	1	1	1	3
OG0006277	0	1	1	1	3
OG0006278	0	1	1	1	3
OG0006279	0	1	1	1	3
OG0006280	0	1	1	1	3
OG0006281	0	1	1	1	3
OG0006282	0	1	1	1	3
OG0006283	0	1	1	1	3
OG0006284	0	1	1	1	3
OG0006285	0	1	1	1	3
OG0006286	0	2	0	1	3
OG0006287	0	1	1	1	3
OG0006288	0	1	1	1	3
OG0006289	0	1	1	1	3
OG0006290	0	1	1	1	3
OG0006291	0	1	1	1	3
OG0006292	0	1	1	1	3
OG0006293	0	1	1	1	3
OG0006294	0	1	1	1	3
OG0006295	0	1	1	1	3
OG0006296	0	1	1	1	3
OG0006297	0	1	1	1	3
OG0006298	0	1	1	1	3
OG0006299	0	1	1	1	3
OG0006300	0	1	2	0	3
OG0006301	0	1	1	1	3
OG0006302	0	1	1	1	3
OG0006303	0	1	1	1	3
OG0006304	0	1	1	1	3
OG0006305	0	1	1	1	3
OG0006306	0	1	1	1	3
OG0006307	0	1	1	1	3
OG0006308	0	1	1	1	3
OG0006309	0	1	1	1	3
OG0006310	0	1	2	0	3
OG0006311	0	1	1	1	3
OG0006312	0	1	1	1	3
OG0006313	0	1	1	1	3
OG0006314	0	1	0	2	3
OG0006315	0	1	1	1	3
OG0006316	0	1	1	1	3
OG0006317	0	2	0	1	3
OG0006318	0	1	0	2	3
OG0006319	0	1	1	1	3
OG0006320	0	1	1	1	3
OG0006321	0	1	1	1	3
OG0006322	0	1	1	1	3
OG0006323	0	1	1	1	3
OG0006324	0	1	2	0	3
OG0006325	0	1	1	1	3
OG0006326	0	1	1	1	3
OG0006327	0	1	1	1	3
OG0006328	0	1	1	1	3
OG0006329	0	1	2	0	3
OG0006330	0	1	1	1	3
OG0006331	0	1	1	1	3
OG0006332	0	1	1	1	3
OG0006333	0	1	1	1	3
OG0006334	0	1	1	1	3
OG0006335	0	1	1	1	3
OG0006336	0	1	1	1	3
OG0006337	0	1	1	1	3
OG0006338	0	1	1	1	3
OG0006339	0	1	2	0	3
OG0006340	0	1	1	1	3
OG0006341	0	1	1	1	3
OG0006342	0	1	2	0	3
OG0006343	0	2	0	1	3
OG0006344	0	1	1	1	3
OG0006345	0	1	1	1	3
OG0006346	0	1	1	1	3
OG0006347	0	1	1	1	3
OG0006348	0	1	1	1	3
OG0006349	0	1	0	2	3
OG0006350	0	1	1	1	3
OG0006351	0	1	1	1	3
OG0006352	0	1	1	1	3
OG0006353	0	1	1	1	3
OG0006354	0	1	1	1	3
OG0006355	0	1	1	1	3
OG0006356	0	1	0	2	3
OG0006357	0	1	0	2	3
OG0006358	0	1	1	1	3
OG0006359	0	1	1	1	3
OG0006360	0	1	1	1	3
OG0006361	0	1	1	1	3
OG0006362	0	1	0	2	3
OG0006363	0	1	1	1	3
OG0006364	0	1	1	1	3
OG0006365	0	1	1	1	3
OG0006366	0	1	1	1	3
OG0006367	0	1	1	1	3
OG0006368	0	1	1	1	3
OG0006369	0	1	1	1	3
OG0006370	0	1	1	1	3
OG0006371	0	1	1	1	3
OG0006372	0	1	1	1	3
OG0006373	0	1	1	1	3
OG0006374	0	1	1	1	3
OG0006375	0	1	1	1	3
OG0006376	0	1	1	1	3
OG0006377	0	1	2	0	3
OG0006378	0	1	1	1	3
OG0006379	0	1	1	1	3
OG0006380	0	1	1	1	3
OG0006381	0	1	1	1	3
OG0006382	0	1	1	1	3
OG0006383	0	1	1	1	3
OG0006384	0	1	1	1	3
OG0006385	0	1	1	1	3
OG0006386	0	1	1	1	3
OG0006387	0	2	0	1	3
OG0006388	0	1	1	1	3
OG0006389	0	1	1	1	3
OG0006390	0	1	1	1	3
OG0006391	0	1	1	1	3
OG0006392	0	1	1	1	3
OG0006393	0	1	1	1	3
OG0006394	0	2	0	1	3
OG0006395	0	1	1	1	3
OG0006396	0	1	1	1	3
OG0006397	0	1	2	0	3
OG0006398	0	1	1	1	3
OG0006399	0	1	1	1	3
OG0006400	0	1	1	1	3
OG0006401	0	1	1	1	3
OG0006402	0	1	1	1	3
OG0006403	0	1	1	1	3
OG0006404	0	1	1	1	3
OG0006405	0	1	0	2	3
OG0006406	0	1	1	1	3
OG0006407	0	1	1	1	3
OG0006408	0	1	1	1	3
OG0006409	0	1	1	1	3
OG0006410	0	1	1	1	3
OG0006411	0	1	1	1	3
OG0006412	0	1	1	1	3
OG0006413	0	1	1	1	3
OG0006414	0	1	1	1	3
OG0006415	0	1	1	1	3
OG0006416	0	1	1	1	3
OG0006417	0	1	1	1	3
OG0006418	0	1	1	1	3
OG0006419	0	1	1	1	3
OG0006420	0	1	1	1	3
OG0006421	0	1	1	1	3
OG0006422	0	1	1	1	3
OG0006423	0	1	1	1	3
OG0006424	0	1	1	1	3
OG0006425	0	1	1	1	3
OG0006426	0	1	1	1	3
OG0006427	0	1	1	1	3
OG0006428	0	1	1	1	3
OG0006429	0	1	1	1	3
OG0006430	0	1	1	1	3
OG0006431	0	1	1	1	3
OG0006432	0	1	1	1	3
OG0006433	0	1	1	1	3
OG0006434	0	1	0	2	3
OG0006435	0	1	1	1	3
OG0006436	0	1	1	1	3
OG0006437	0	1	1	1	3
OG0006438	0	2	1	0	3
OG0006439	0	1	1	1	3
OG0006440	0	1	1	1	3
OG0006441	0	1	1	1	3
OG0006442	0	1	1	1	3
OG0006443	0	1	1	1	3
OG0006444	0	1	1	1	3
OG0006445	0	1	1	1	3
OG0006446	0	1	1	1	3
OG0006447	0	1	1	1	3
OG0006448	0	1	1	1	3
OG0006449	0	1	1	1	3
OG0006450	0	1	1	1	3
OG0006451	0	1	1	1	3
OG0006452	0	1	1	1	3
OG0006453	0	1	1	1	3
OG0006454	0	1	1	1	3
OG0006455	0	1	1	1	3
OG0006456	0	1	1	1	3
OG0006457	0	1	1	1	3
OG0006458	0	1	1	1	3
OG0006459	0	1	1	1	3
OG0006460	0	1	1	1	3
OG0006461	0	1	1	1	3
OG0006462	0	1	1	1	3
OG0006463	0	1	2	0	3
OG0006464	0	1	2	0	3
OG0006465	0	1	1	1	3
OG0006466	0	1	1	1	3
OG0006467	0	1	1	1	3
OG0006468	0	1	1	1	3
OG0006469	0	1	1	1	3
OG0006470	0	1	2	0	3
OG0006471	0	1	0	2	3
OG0006472	0	1	1	1	3
OG0006473	0	1	1	1	3
OG0006474	0	1	1	1	3
OG0006475	0	1	1	1	3
OG0006476	0	1	1	1	3
OG0006477	0	1	1	1	3
OG0006478	0	1	1	1	3
OG0006479	0	1	1	1	3
OG0006480	0	1	1	1	3
OG0006481	0	1	2	0	3
OG0006482	0	1	1	1	3
OG0006483	0	2	1	0	3
OG0006484	0	1	1	1	3
OG0006485	0	1	1	1	3
OG0006486	0	1	1	1	3
OG0006487	0	3	0	0	3
OG0006488	0	1	1	1	3
OG0006489	0	1	1	1	3
OG0006490	0	1	1	1	3
OG0006491	0	1	1	1	3
OG0006492	0	1	1	1	3
OG0006493	0	1	1	1	3
OG0006494	0	1	1	1	3
OG0006495	0	1	1	1	3
OG0006496	0	1	1	1	3
OG0006497	0	1	1	1	3
OG0006498	0	1	1	1	3
OG0006499	0	1	1	1	3
OG0006500	0	1	2	0	3
OG0006501	0	1	1	1	3
OG0006502	0	1	1	1	3
OG0006503	0	1	1	1	3
OG0006504	0	1	1	1	3
OG0006505	0	1	1	1	3
OG0006506	0	1	2	0	3
OG0006507	0	1	1	1	3
OG0006508	0	1	1	1	3
OG0006509	0	1	1	1	3
OG0006510	0	1	1	1	3
OG0006511	0	1	1	1	3
OG0006512	0	1	2	0	3
OG0006513	0	1	1	1	3
OG0006514	0	1	1	1	3
OG0006515	0	1	1	1	3
OG0006516	0	1	1	1	3
OG0006517	0	1	2	0	3
OG0006518	0	1	1	1	3
OG0006519	0	1	1	1	3
OG0006520	0	1	1	1	3
OG0006521	0	1	1	1	3
OG0006522	0	1	0	2	3
OG0006523	0	1	1	1	3
OG0006524	0	1	1	1	3
OG0006525	0	1	1	1	3
OG0006526	0	1	1	1	3
OG0006527	0	1	1	1	3
OG0006528	0	1	1	1	3
OG0006529	0	1	1	1	3
OG0006530	0	1	1	1	3
OG0006531	0	1	1	1	3
OG0006532	0	1	1	1	3
OG0006533	0	1	1	1	3
OG0006534	0	1	2	0	3
OG0006535	0	2	1	0	3
OG0006536	0	1	1	1	3
OG0006537	0	1	1	1	3
OG0006538	0	1	1	1	3
OG0006539	0	1	1	1	3
OG0006540	0	1	1	1	3
OG0006541	0	1	1	1	3
OG0006542	0	1	1	1	3
OG0006543	0	1	1	1	3
OG0006544	0	1	1	1	3
OG0006545	0	2	1	0	3
OG0006546	0	1	1	1	3
OG0006547	0	1	1	1	3
OG0006548	0	1	1	1	3
OG0006549	0	1	1	1	3
OG0006550	0	1	1	1	3
OG0006551	0	1	1	1	3
OG0006552	0	1	2	0	3
OG0006553	0	1	1	1	3
OG0006554	0	1	2	0	3
OG0006555	0	1	1	1	3
OG0006556	0	1	1	1	3
OG0006557	0	1	2	0	3
OG0006558	0	1	1	1	3
OG0006559	0	1	1	1	3
OG0006560	0	1	1	1	3
OG0006561	0	1	1	1	3
OG0006562	0	1	1	1	3
OG0006563	0	1	1	1	3
OG0006564	0	1	1	1	3
OG0006565	0	1	1	1	3
OG0006566	0	1	1	1	3
OG0006567	0	1	1	1	3
OG0006568	0	1	1	1	3
OG0006569	0	1	1	1	3
OG0006570	0	1	1	1	3
OG0006571	0	1	1	1	3
OG0006572	0	1	1	1	3
OG0006573	0	1	1	1	3
OG0006574	0	1	1	1	3
OG0006575	0	1	1	1	3
OG0006576	0	1	0	2	3
OG0006577	0	1	1	1	3
OG0006578	0	1	1	1	3
OG0006579	0	1	1	1	3
OG0006580	0	1	1	1	3
OG0006581	0	1	0	2	3
OG0006582	0	1	1	1	3
OG0006583	0	1	1	1	3
OG0006584	0	1	1	1	3
OG0006585	0	1	1	1	3
OG0006586	0	1	1	1	3
OG0006587	0	2	1	0	3
OG0006588	0	1	0	2	3
OG0006589	0	1	1	1	3
OG0006590	0	1	1	1	3
OG0006591	0	1	1	1	3
OG0006592	0	1	1	1	3
OG0006593	0	1	1	1	3
OG0006594	0	3	0	0	3
OG0006595	0	1	1	1	3
OG0006596	0	1	1	1	3
OG0006597	0	1	1	1	3
OG0006598	0	1	1	1	3
OG0006599	0	1	2	0	3
OG0006600	0	1	1	1	3
OG0006601	0	1	1	1	3
OG0006602	0	1	1	1	3
OG0006603	0	1	1	1	3
OG0006604	0	1	1	1	3
OG0006605	0	1	1	1	3
OG0006606	0	1	1	1	3
OG0006607	0	1	1	1	3
OG0006608	0	1	1	1	3
OG0006609	0	1	1	1	3
OG0006610	0	1	1	1	3
OG0006611	0	1	1	1	3
OG0006612	0	1	1	1	3
OG0006613	0	1	1	1	3
OG0006614	0	1	1	1	3
OG0006615	0	1	1	1	3
OG0006616	0	1	1	1	3
OG0006617	0	2	0	1	3
OG0006618	0	1	1	1	3
OG0006619	0	1	1	1	3
OG0006620	0	1	1	1	3
OG0006621	0	1	1	1	3
OG0006622	0	1	1	1	3
OG0006623	0	1	1	1	3
OG0006624	0	1	1	1	3
OG0006625	0	1	1	1	3
OG0006626	0	1	1	1	3
OG0006627	0	1	1	1	3
OG0006628	0	1	1	1	3
OG0006629	0	1	1	1	3
OG0006630	0	1	0	2	3
OG0006631	0	1	1	1	3
OG0006632	0	1	1	1	3
OG0006633	0	1	2	0	3
OG0006634	0	1	1	1	3
OG0006635	0	1	1	1	3
OG0006636	0	1	1	1	3
OG0006637	0	1	1	1	3
OG0006638	0	1	1	1	3
OG0006639	0	1	1	1	3
OG0006640	0	1	1	1	3
OG0006641	0	1	1	1	3
OG0006642	0	1	1	1	3
OG0006643	0	1	1	1	3
OG0006644	0	1	1	1	3
OG0006645	0	1	1	1	3
OG0006646	0	1	1	1	3
OG0006647	0	1	1	1	3
OG0006648	0	1	1	1	3
OG0006649	0	1	1	1	3
OG0006650	0	1	1	1	3
OG0006651	0	1	1	1	3
OG0006652	0	1	1	1	3
OG0006653	0	1	1	1	3
OG0006654	0	1	1	1	3
OG0006655	0	1	1	1	3
OG0006656	0	1	1	1	3
OG0006657	0	1	1	1	3
OG0006658	0	1	1	1	3
OG0006659	0	1	1	1	3
OG0006660	0	1	1	1	3
OG0006661	0	1	1	1	3
OG0006662	0	1	0	2	3
OG0006663	0	1	2	0	3
OG0006664	0	1	1	1	3
OG0006665	0	1	1	1	3
OG0006666	0	1	2	0	3
OG0006667	0	1	1	1	3
OG0006668	0	1	1	1	3
OG0006669	0	1	1	1	3
OG0006670	0	1	1	1	3
OG0006671	0	1	1	1	3
OG0006672	0	1	1	1	3
OG0006673	0	1	1	1	3
OG0006674	0	1	1	1	3
OG0006675	0	1	1	1	3
OG0006676	0	1	1	1	3
OG0006677	0	1	1	1	3
OG0006678	0	1	1	1	3
OG0006679	0	1	1	1	3
OG0006680	0	1	1	1	3
OG0006681	0	1	1	1	3
OG0006682	0	1	1	1	3
OG0006683	0	1	1	1	3
OG0006684	0	1	1	1	3
OG0006685	0	2	0	1	3
OG0006686	0	1	1	1	3
OG0006687	0	1	1	1	3
OG0006688	0	1	1	1	3
OG0006689	0	1	1	1	3
OG0006690	0	1	2	0	3
OG0006691	0	1	1	1	3
OG0006692	0	1	1	1	3
OG0006693	0	1	1	1	3
OG0006694	0	1	1	1	3
OG0006695	0	1	1	1	3
OG0006696	0	1	1	1	3
OG0006697	0	2	0	1	3
OG0006698	0	1	1	1	3
OG0006699	0	1	0	2	3
OG0006700	0	1	1	1	3
OG0006701	0	1	1	1	3
OG0006702	0	1	1	1	3
OG0006703	0	1	1	1	3
OG0006704	0	1	1	1	3
OG0006705	0	1	1	1	3
OG0006706	0	1	2	0	3
OG0006707	0	2	1	0	3
OG0006708	0	1	1	1	3
OG0006709	0	1	1	1	3
OG0006710	0	1	1	1	3
OG0006711	0	1	1	1	3
OG0006712	0	2	1	0	3
OG0006713	0	1	1	1	3
OG0006714	0	1	1	1	3
OG0006715	0	1	2	0	3
OG0006716	0	1	1	1	3
OG0006717	0	1	1	1	3
OG0006718	0	1	1	1	3
OG0006719	0	1	1	1	3
OG0006720	0	1	1	1	3
OG0006721	0	1	1	1	3
OG0006722	0	1	1	1	3
OG0006723	0	1	1	1	3
OG0006724	0	1	1	1	3
OG0006725	0	1	1	1	3
OG0006726	0	1	1	1	3
OG0006727	0	1	1	1	3
OG0006728	0	1	1	1	3
OG0006729	0	1	1	1	3
OG0006730	0	1	1	1	3
OG0006731	0	1	1	1	3
OG0006732	0	1	1	1	3
OG0006733	0	1	1	1	3
OG0006734	0	1	1	1	3
OG0006735	0	1	1	1	3
OG0006736	0	1	1	1	3
OG0006737	0	1	1	1	3
OG0006738	0	1	1	1	3
OG0006739	0	1	0	2	3
OG0006740	0	1	1	1	3
OG0006741	0	1	1	1	3
OG0006742	0	1	1	1	3
OG0006743	0	1	1	1	3
OG0006744	0	1	1	1	3
OG0006745	0	1	1	1	3
OG0006746	0	1	1	1	3
OG0006747	0	1	1	1	3
OG0006748	0	1	1	1	3
OG0006749	0	1	1	1	3
OG0006750	0	1	1	1	3
OG0006751	0	1	1	1	3
OG0006752	0	1	1	1	3
OG0006753	0	1	1	1	3
OG0006754	0	1	1	1	3
OG0006755	0	1	1	1	3
OG0006756	0	1	0	2	3
OG0006757	0	1	1	1	3
OG0006758	0	1	1	1	3
OG0006759	0	1	1	1	3
OG0006760	0	1	1	1	3
OG0006761	0	1	1	1	3
OG0006762	0	1	1	1	3
OG0006763	0	1	1	1	3
OG0006764	0	1	1	1	3
OG0006765	0	1	1	1	3
OG0006766	0	1	1	1	3
OG0006767	0	1	1	1	3
OG0006768	0	1	1	1	3
OG0006769	0	1	1	1	3
OG0006770	0	1	1	1	3
OG0006771	0	1	2	0	3
OG0006772	0	1	1	1	3
OG0006773	0	1	1	1	3
OG0006774	0	1	1	1	3
OG0006775	0	1	1	1	3
OG0006776	0	1	1	1	3
OG0006777	0	1	1	1	3
OG0006778	0	1	1	1	3
OG0006779	0	1	1	1	3
OG0006780	0	1	1	1	3
OG0006781	0	1	1	1	3
OG0006782	0	1	1	1	3
OG0006783	0	1	1	1	3
OG0006784	0	1	1	1	3
OG0006785	0	1	1	1	3
OG0006786	0	2	0	1	3
OG0006787	0	1	1	1	3
OG0006788	0	1	1	1	3
OG0006789	0	1	1	1	3
OG0006790	0	1	1	1	3
OG0006791	0	1	1	1	3
OG0006792	0	1	1	1	3
OG0006793	0	1	1	1	3
OG0006794	0	1	1	1	3
OG0006795	0	1	1	1	3
OG0006796	0	1	1	1	3
OG0006797	0	1	1	1	3
OG0006798	0	1	1	1	3
OG0006799	0	1	1	1	3
OG0006800	0	1	1	1	3
OG0006801	0	1	1	1	3
OG0006802	0	1	0	2	3
OG0006803	0	1	2	0	3
OG0006804	0	1	1	1	3
OG0006805	0	1	2	0	3
OG0006806	0	1	1	1	3
OG0006807	0	1	1	1	3
OG0006808	0	1	1	1	3
OG0006809	0	1	1	1	3
OG0006810	0	1	1	1	3
OG0006811	0	1	1	1	3
OG0006812	0	1	1	1	3
OG0006813	0	1	1	1	3
OG0006814	0	1	1	1	3
OG0006815	0	1	1	1	3
OG0006816	0	1	1	1	3
OG0006817	0	1	1	1	3
OG0006818	0	1	1	1	3
OG0006819	0	1	1	1	3
OG0006820	0	1	1	1	3
OG0006821	0	1	0	2	3
OG0006822	0	1	1	1	3
OG0006823	0	1	1	1	3
OG0006824	0	1	1	1	3
OG0006825	0	1	1	1	3
OG0006826	0	1	1	1	3
OG0006827	0	1	1	1	3
OG0006828	0	1	1	1	3
OG0006829	0	1	1	1	3
OG0006830	0	1	1	1	3
OG0006831	0	1	1	1	3
OG0006832	0	1	1	1	3
OG0006833	0	1	1	1	3
OG0006834	0	1	1	1	3
OG0006835	0	1	1	1	3
OG0006836	0	1	1	1	3
OG0006837	0	1	1	1	3
OG0006838	0	1	1	1	3
OG0006839	0	1	1	1	3
OG0006840	0	2	1	0	3
OG0006841	0	1	1	1	3
OG0006842	0	1	1	1	3
OG0006843	0	1	1	1	3
OG0006844	0	1	1	1	3
OG0006845	0	1	1	1	3
OG0006846	0	1	0	2	3
OG0006847	0	1	1	1	3
OG0006848	0	1	1	1	3
OG0006849	0	1	1	1	3
OG0006850	0	1	1	1	3
OG0006851	0	1	1	1	3
OG0006852	0	1	1	1	3
OG0006853	0	2	1	0	3
OG0006854	0	1	1	1	3
OG0006855	0	1	1	1	3
OG0006856	0	1	1	1	3
OG0006857	0	1	1	1	3
OG0006858	0	1	1	1	3
OG0006859	0	1	1	1	3
OG0006860	0	1	1	1	3
OG0006861	0	1	1	1	3
OG0006862	0	1	1	1	3
OG0006863	0	1	1	1	3
OG0006864	0	1	1	1	3
OG0006865	0	1	1	1	3
OG0006866	0	1	1	1	3
OG0006867	0	1	1	1	3
OG0006868	0	1	1	1	3
OG0006869	0	1	1	1	3
OG0006870	0	1	0	2	3
OG0006871	0	1	1	1	3
OG0006872	0	1	1	1	3
OG0006873	0	1	1	1	3
OG0006874	0	1	1	1	3
OG0006875	0	1	1	1	3
OG0006876	0	1	1	1	3
OG0006877	0	1	1	1	3
OG0006878	0	1	1	1	3
OG0006879	0	1	1	1	3
OG0006880	0	1	1	1	3
OG0006881	0	1	1	1	3
OG0006882	0	1	1	1	3
OG0006883	0	1	1	1	3
OG0006884	0	1	1	1	3
OG0006885	0	1	2	0	3
OG0006886	0	1	1	1	3
OG0006887	0	1	1	1	3
OG0006888	0	1	1	1	3
OG0006889	0	1	1	1	3
OG0006890	0	1	1	1	3
OG0006891	0	1	1	1	3
OG0006892	0	1	1	1	3
OG0006893	0	1	1	1	3
OG0006894	0	1	1	1	3
OG0006895	0	1	1	1	3
OG0006896	0	1	1	1	3
OG0006897	0	1	1	1	3
OG0006898	0	1	0	2	3
OG0006899	0	1	1	1	3
OG0006900	0	1	1	1	3
OG0006901	0	1	1	1	3
OG0006902	0	1	1	1	3
OG0006903	0	1	1	1	3
OG0006904	0	1	1	1	3
OG0006905	0	1	1	1	3
OG0006906	0	1	1	1	3
OG0006907	0	1	1	1	3
OG0006908	0	1	1	1	3
OG0006909	0	1	1	1	3
OG0006910	0	1	1	1	3
OG0006911	0	1	1	1	3
OG0006912	0	1	1	1	3
OG0006913	0	1	1	1	3
OG0006914	0	1	1	1	3
OG0006915	0	1	1	1	3
OG0006916	0	1	2	0	3
OG0006917	0	1	0	2	3
OG0006918	0	1	1	1	3
OG0006919	0	1	2	0	3
OG0006920	0	1	2	0	3
OG0006921	0	1	1	1	3
OG0006922	0	1	1	1	3
OG0006923	0	1	1	1	3
OG0006924	0	1	1	1	3
OG0006925	0	1	1	1	3
OG0006926	0	1	1	1	3
OG0006927	0	1	1	1	3
OG0006928	0	1	2	0	3
OG0006929	0	1	1	1	3
OG0006930	0	1	1	1	3
OG0006931	0	1	1	1	3
OG0006932	0	1	1	1	3
OG0006933	0	1	1	1	3
OG0006934	0	1	1	1	3
OG0006935	0	1	1	1	3
OG0006936	0	1	1	1	3
OG0006937	0	1	1	1	3
OG0006938	0	1	1	1	3
OG0006939	0	1	1	1	3
OG0006940	0	1	1	1	3
OG0006941	0	1	1	1	3
OG0006942	0	1	1	1	3
OG0006943	0	1	2	0	3
OG0006944	0	1	1	1	3
OG0006945	0	1	1	1	3
OG0006946	0	1	1	1	3
OG0006947	0	1	1	1	3
OG0006948	0	1	1	1	3
OG0006949	0	1	1	1	3
OG0006950	0	1	1	1	3
OG0006951	0	1	1	1	3
OG0006952	0	1	0	2	3
OG0006953	0	1	2	0	3
OG0006954	0	1	1	1	3
OG0006955	0	1	1	1	3
OG0006956	0	1	1	1	3
OG0006957	0	1	1	1	3
OG0006958	0	1	1	1	3
OG0006959	0	1	1	1	3
OG0006960	0	1	1	1	3
OG0006961	0	1	1	1	3
OG0006962	0	1	1	1	3
OG0006963	0	1	1	1	3
OG0006964	0	1	1	1	3
OG0006965	0	1	1	1	3
OG0006966	0	1	1	1	3
OG0006967	0	1	1	1	3
OG0006968	0	1	1	1	3
OG0006969	0	1	1	1	3
OG0006970	0	1	1	1	3
OG0006971	0	1	1	1	3
OG0006972	0	1	1	1	3
OG0006973	0	1	0	2	3
OG0006974	0	1	2	0	3
OG0006975	0	0	3	0	3
OG0006976	0	0	2	1	3
OG0006977	0	0	1	2	3
OG0006978	0	0	1	2	3
OG0006979	0	0	1	2	3
OG0006980	0	0	2	1	3
OG0006981	0	0	2	1	3
OG0006982	0	0	1	2	3
OG0006983	0	0	1	2	3
OG0006984	0	0	1	2	3
OG0006985	0	0	2	1	3
OG0006986	0	0	1	2	3
OG0006987	0	0	2	1	3
OG0006988	0	0	1	2	3
OG0006989	0	0	1	2	3
OG0006990	0	0	1	2	3
OG0006991	0	0	3	0	3
OG0006992	0	0	2	1	3
OG0006993	0	0	2	1	3
OG0006994	0	0	3	0	3
OG0006995	0	0	1	2	3
OG0006996	0	0	1	2	3
OG0006997	0	0	1	2	3
OG0006998	0	0	1	2	3
OG0006999	0	0	3	0	3
OG0007000	0	0	1	2	3
OG0007001	0	0	3	0	3
OG0007002	0	0	2	1	3
OG0007003	0	0	1	2	3
OG0007004	0	0	1	2	3
OG0007005	0	0	2	1	3
OG0007006	0	0	3	0	3
OG0007007	0	0	3	0	3
OG0007008	0	0	1	2	3
OG0007009	0	0	2	1	3
OG0007010	0	0	2	1	3
OG0007011	0	0	3	0	3
OG0007012	0	0	1	2	3
OG0007013	0	0	3	0	3
OG0007014	0	0	1	2	3
OG0007015	0	0	2	1	3
OG0007016	0	0	3	0	3
OG0007017	0	0	1	2	3
OG0007018	0	0	2	1	3
OG0007019	0	0	1	2	3
OG0007020	0	0	1	2	3
OG0007021	0	0	0	3	3
OG0007022	0	0	0	3	3
OG0007023	0	0	0	3	3
OG0007024	0	0	0	3	3
OG0007025	0	0	0	3	3
OG0007026	0	0	0	3	3
OG0007027	0	0	0	3	3
OG0007028	0	0	0	3	3
OG0007029	0	0	0	3	3
OG0007030	1	1	0	0	2
OG0007031	2	0	0	0	2
OG0007032	1	0	1	0	2
OG0007033	2	0	0	0	2
OG0007034	1	1	0	0	2
OG0007035	1	1	0	0	2
OG0007036	1	1	0	0	2
OG0007037	1	1	0	0	2
OG0007038	1	0	1	0	2
OG0007039	1	1	0	0	2
OG0007040	1	1	0	0	2
OG0007041	1	1	0	0	2
OG0007042	1	1	0	0	2
OG0007043	1	0	0	1	2
OG0007044	1	0	0	1	2
OG0007045	1	1	0	0	2
OG0007046	1	1	0	0	2
OG0007047	1	1	0	0	2
OG0007048	1	1	0	0	2
OG0007049	1	0	1	0	2
OG0007050	1	1	0	0	2
OG0007051	1	1	0	0	2
OG0007052	1	1	0	0	2
OG0007053	1	1	0	0	2
OG0007054	1	1	0	0	2
OG0007055	1	1	0	0	2
OG0007056	1	1	0	0	2
OG0007057	1	1	0	0	2
OG0007058	1	1	0	0	2
OG0007059	1	1	0	0	2
OG0007060	1	1	0	0	2
OG0007061	1	1	0	0	2
OG0007062	1	0	0	1	2
OG0007063	1	1	0	0	2
OG0007064	1	1	0	0	2
OG0007065	1	1	0	0	2
OG0007066	1	1	0	0	2
OG0007067	1	1	0	0	2
OG0007068	1	1	0	0	2
OG0007069	1	1	0	0	2
OG0007070	1	1	0	0	2
OG0007071	1	1	0	0	2
OG0007072	1	1	0	0	2
OG0007073	1	1	0	0	2
OG0007074	1	1	0	0	2
OG0007075	1	1	0	0	2
OG0007076	1	1	0	0	2
OG0007077	1	1	0	0	2
OG0007078	1	1	0	0	2
OG0007079	1	1	0	0	2
OG0007080	1	0	1	0	2
OG0007081	1	1	0	0	2
OG0007082	1	0	0	1	2
OG0007083	1	0	1	0	2
OG0007084	2	0	0	0	2
OG0007085	1	0	0	1	2
OG0007086	1	0	1	0	2
OG0007087	2	0	0	0	2
OG0007088	1	1	0	0	2
OG0007089	1	1	0	0	2
OG0007090	1	1	0	0	2
OG0007091	1	0	1	0	2
OG0007092	2	0	0	0	2
OG0007093	1	1	0	0	2
OG0007094	1	1	0	0	2
OG0007095	1	0	1	0	2
OG0007096	1	1	0	0	2
OG0007097	1	1	0	0	2
OG0007098	1	1	0	0	2
OG0007099	2	0	0	0	2
OG0007100	1	1	0	0	2
OG0007101	2	0	0	0	2
OG0007102	1	1	0	0	2
OG0007103	1	1	0	0	2
OG0007104	1	1	0	0	2
OG0007105	1	1	0	0	2
OG0007106	1	1	0	0	2
OG0007107	1	0	1	0	2
OG0007108	1	1	0	0	2
OG0007109	1	1	0	0	2
OG0007110	1	1	0	0	2
OG0007111	1	1	0	0	2
OG0007112	1	1	0	0	2
OG0007113	2	0	0	0	2
OG0007114	1	1	0	0	2
OG0007115	1	0	1	0	2
OG0007116	1	1	0	0	2
OG0007117	1	1	0	0	2
OG0007118	1	0	0	1	2
OG0007119	1	1	0	0	2
OG0007120	1	0	1	0	2
OG0007121	2	0	0	0	2
OG0007122	2	0	0	0	2
OG0007123	2	0	0	0	2
OG0007124	1	1	0	0	2
OG0007125	1	1	0	0	2
OG0007126	1	1	0	0	2
OG0007127	2	0	0	0	2
OG0007128	1	1	0	0	2
OG0007129	1	1	0	0	2
OG0007130	1	1	0	0	2
OG0007131	1	1	0	0	2
OG0007132	1	1	0	0	2
OG0007133	1	1	0	0	2
OG0007134	1	1	0	0	2
OG0007135	1	1	0	0	2
OG0007136	1	1	0	0	2
OG0007137	2	0	0	0	2
OG0007138	1	1	0	0	2
OG0007139	1	0	1	0	2
OG0007140	1	1	0	0	2
OG0007141	1	0	1	0	2
OG0007142	2	0	0	0	2
OG0007143	1	1	0	0	2
OG0007144	2	0	0	0	2
OG0007145	1	1	0	0	2
OG0007146	2	0	0	0	2
OG0007147	1	1	0	0	2
OG0007148	1	1	0	0	2
OG0007149	1	0	1	0	2
OG0007150	1	0	1	0	2
OG0007151	2	0	0	0	2
OG0007152	2	0	0	0	2
OG0007153	1	1	0	0	2
OG0007154	1	1	0	0	2
OG0007155	1	1	0	0	2
OG0007156	1	1	0	0	2
OG0007157	1	1	0	0	2
OG0007158	1	1	0	0	2
OG0007159	2	0	0	0	2
OG0007160	1	1	0	0	2
OG0007161	2	0	0	0	2
OG0007162	1	0	0	1	2
OG0007163	1	1	0	0	2
OG0007164	1	1	0	0	2
OG0007165	1	0	1	0	2
OG0007166	1	1	0	0	2
OG0007167	1	0	0	1	2
OG0007168	1	1	0	0	2
OG0007169	1	1	0	0	2
OG0007170	2	0	0	0	2
OG0007171	1	1	0	0	2
OG0007172	1	1	0	0	2
OG0007173	2	0	0	0	2
OG0007174	1	0	1	0	2
OG0007175	2	0	0	0	2
OG0007176	1	1	0	0	2
OG0007177	2	0	0	0	2
OG0007178	1	1	0	0	2
OG0007179	1	1	0	0	2
OG0007180	1	0	1	0	2
OG0007181	1	0	1	0	2
OG0007182	1	1	0	0	2
OG0007183	1	0	1	0	2
OG0007184	1	0	1	0	2
OG0007185	1	0	1	0	2
OG0007186	1	0	0	1	2
OG0007187	2	0	0	0	2
OG0007188	1	1	0	0	2
OG0007189	2	0	0	0	2
OG0007190	1	1	0	0	2
OG0007191	1	1	0	0	2
OG0007192	1	1	0	0	2
OG0007193	1	1	0	0	2
OG0007194	1	0	1	0	2
OG0007195	1	1	0	0	2
OG0007196	1	1	0	0	2
OG0007197	1	1	0	0	2
OG0007198	1	1	0	0	2
OG0007199	2	0	0	0	2
OG0007200	1	1	0	0	2
OG0007201	1	1	0	0	2
OG0007202	1	1	0	0	2
OG0007203	1	1	0	0	2
OG0007204	1	1	0	0	2
OG0007205	1	0	0	1	2
OG0007206	1	0	1	0	2
OG0007207	2	0	0	0	2
OG0007208	1	1	0	0	2
OG0007209	1	1	0	0	2
OG0007210	2	0	0	0	2
OG0007211	1	1	0	0	2
OG0007212	1	1	0	0	2
OG0007213	1	0	0	1	2
OG0007214	1	0	1	0	2
OG0007215	2	0	0	0	2
OG0007216	1	1	0	0	2
OG0007217	1	1	0	0	2
OG0007218	1	1	0	0	2
OG0007219	1	1	0	0	2
OG0007220	1	0	0	1	2
OG0007221	1	0	0	1	2
OG0007222	1	1	0	0	2
OG0007223	1	1	0	0	2
OG0007224	1	1	0	0	2
OG0007225	1	0	0	1	2
OG0007226	1	0	1	0	2
OG0007227	1	0	1	0	2
OG0007228	2	0	0	0	2
OG0007229	1	0	0	1	2
OG0007230	2	0	0	0	2
OG0007231	1	1	0	0	2
OG0007232	1	0	1	0	2
OG0007233	1	1	0	0	2
OG0007234	1	1	0	0	2
OG0007235	1	1	0	0	2
OG0007236	1	0	0	1	2
OG0007237	1	0	0	1	2
OG0007238	1	1	0	0	2
OG0007239	1	0	0	1	2
OG0007240	1	1	0	0	2
OG0007241	1	1	0	0	2
OG0007242	1	0	1	0	2
OG0007243	1	1	0	0	2
OG0007244	1	1	0	0	2
OG0007245	1	1	0	0	2
OG0007246	1	1	0	0	2
OG0007247	1	0	1	0	2
OG0007248	1	0	0	1	2
OG0007249	1	0	1	0	2
OG0007250	1	1	0	0	2
OG0007251	2	0	0	0	2
OG0007252	1	0	1	0	2
OG0007253	1	1	0	0	2
OG0007254	1	0	0	1	2
OG0007255	1	1	0	0	2
OG0007256	1	1	0	0	2
OG0007257	1	0	1	0	2
OG0007258	1	1	0	0	2
OG0007259	1	1	0	0	2
OG0007260	1	0	0	1	2
OG0007261	2	0	0	0	2
OG0007262	1	1	0	0	2
OG0007263	1	1	0	0	2
OG0007264	1	1	0	0	2
OG0007265	2	0	0	0	2
OG0007266	1	1	0	0	2
OG0007267	1	1	0	0	2
OG0007268	1	0	1	0	2
OG0007269	1	0	0	1	2
OG0007270	1	1	0	0	2
OG0007271	1	1	0	0	2
OG0007272	1	1	0	0	2
OG0007273	1	1	0	0	2
OG0007274	1	1	0	0	2
OG0007275	1	1	0	0	2
OG0007276	1	1	0	0	2
OG0007277	1	1	0	0	2
OG0007278	1	1	0	0	2
OG0007279	1	1	0	0	2
OG0007280	1	0	1	0	2
OG0007281	1	1	0	0	2
OG0007282	1	0	0	1	2
OG0007283	1	0	1	0	2
OG0007284	1	0	1	0	2
OG0007285	1	1	0	0	2
OG0007286	1	1	0	0	2
OG0007287	1	1	0	0	2
OG0007288	1	0	1	0	2
OG0007289	1	0	1	0	2
OG0007290	1	1	0	0	2
OG0007291	1	1	0	0	2
OG0007292	1	0	1	0	2
OG0007293	1	1	0	0	2
OG0007294	1	1	0	0	2
OG0007295	1	1	0	0	2
OG0007296	1	1	0	0	2
OG0007297	1	1	0	0	2
OG0007298	1	1	0	0	2
OG0007299	1	1	0	0	2
OG0007300	1	0	1	0	2
OG0007301	1	1	0	0	2
OG0007302	1	1	0	0	2
OG0007303	1	0	0	1	2
OG0007304	2	0	0	0	2
OG0007305	1	0	0	1	2
OG0007306	1	1	0	0	2
OG0007307	2	0	0	0	2
OG0007308	1	1	0	0	2
OG0007309	1	1	0	0	2
OG0007310	2	0	0	0	2
OG0007311	1	1	0	0	2
OG0007312	1	0	0	1	2
OG0007313	1	1	0	0	2
OG0007314	1	1	0	0	2
OG0007315	1	1	0	0	2
OG0007316	1	1	0	0	2
OG0007317	1	0	1	0	2
OG0007318	2	0	0	0	2
OG0007319	1	0	1	0	2
OG0007320	1	1	0	0	2
OG0007321	1	0	1	0	2
OG0007322	1	1	0	0	2
OG0007323	1	1	0	0	2
OG0007324	1	1	0	0	2
OG0007325	2	0	0	0	2
OG0007326	2	0	0	0	2
OG0007327	2	0	0	0	2
OG0007328	1	0	1	0	2
OG0007329	2	0	0	0	2
OG0007330	1	1	0	0	2
OG0007331	1	1	0	0	2
OG0007332	1	1	0	0	2
OG0007333	1	1	0	0	2
OG0007334	1	1	0	0	2
OG0007335	1	1	0	0	2
OG0007336	1	1	0	0	2
OG0007337	1	1	0	0	2
OG0007338	1	1	0	0	2
OG0007339	1	1	0	0	2
OG0007340	1	1	0	0	2
OG0007341	1	1	0	0	2
OG0007342	1	1	0	0	2
OG0007343	1	1	0	0	2
OG0007344	1	1	0	0	2
OG0007345	1	1	0	0	2
OG0007346	1	1	0	0	2
OG0007347	1	1	0	0	2
OG0007348	1	0	1	0	2
OG0007349	1	1	0	0	2
OG0007350	1	1	0	0	2
OG0007351	1	1	0	0	2
OG0007352	1	1	0	0	2
OG0007353	1	1	0	0	2
OG0007354	1	1	0	0	2
OG0007355	1	1	0	0	2
OG0007356	1	1	0	0	2
OG0007357	1	1	0	0	2
OG0007358	1	1	0	0	2
OG0007359	1	1	0	0	2
OG0007360	1	1	0	0	2
OG0007361	1	1	0	0	2
OG0007362	1	1	0	0	2
OG0007363	1	0	0	1	2
OG0007364	1	1	0	0	2
OG0007365	1	1	0	0	2
OG0007366	1	1	0	0	2
OG0007367	1	0	1	0	2
OG0007368	1	1	0	0	2
OG0007369	1	1	0	0	2
OG0007370	1	1	0	0	2
OG0007371	1	1	0	0	2
OG0007372	1	1	0	0	2
OG0007373	1	1	0	0	2
OG0007374	1	1	0	0	2
OG0007375	1	0	0	1	2
OG0007376	1	1	0	0	2
OG0007377	1	1	0	0	2
OG0007378	1	1	0	0	2
OG0007379	1	1	0	0	2
OG0007380	1	1	0	0	2
OG0007381	1	1	0	0	2
OG0007382	1	1	0	0	2
OG0007383	1	1	0	0	2
OG0007384	1	1	0	0	2
OG0007385	1	1	0	0	2
OG0007386	1	1	0	0	2
OG0007387	1	1	0	0	2
OG0007388	1	1	0	0	2
OG0007389	1	0	0	1	2
OG0007390	1	1	0	0	2
OG0007391	1	0	0	1	2
OG0007392	1	1	0	0	2
OG0007393	1	1	0	0	2
OG0007394	1	1	0	0	2
OG0007395	0	1	1	0	2
OG0007396	0	1	1	0	2
OG0007397	0	2	0	0	2
OG0007398	0	2	0	0	2
OG0007399	0	1	1	0	2
OG0007400	0	1	1	0	2
OG0007401	0	1	0	1	2
OG0007402	0	2	0	0	2
OG0007403	0	1	1	0	2
OG0007404	0	1	1	0	2
OG0007405	0	1	0	1	2
OG0007406	0	1	0	1	2
OG0007407	0	1	0	1	2
OG0007408	0	1	1	0	2
OG0007409	0	1	1	0	2
OG0007410	0	2	0	0	2
OG0007411	0	1	1	0	2
OG0007412	0	1	1	0	2
OG0007413	0	1	1	0	2
OG0007414	0	1	0	1	2
OG0007415	0	1	1	0	2
OG0007416	0	1	0	1	2
OG0007417	0	1	0	1	2
OG0007418	0	1	1	0	2
OG0007419	0	2	0	0	2
OG0007420	0	1	0	1	2
OG0007421	0	1	0	1	2
OG0007422	0	1	0	1	2
OG0007423	0	1	0	1	2
OG0007424	0	1	0	1	2
OG0007425	0	1	1	0	2
OG0007426	0	1	0	1	2
OG0007427	0	2	0	0	2
OG0007428	0	1	1	0	2
OG0007429	0	1	1	0	2
OG0007430	0	1	0	1	2
OG0007431	0	1	1	0	2
OG0007432	0	1	0	1	2
OG0007433	0	1	1	0	2
OG0007434	0	1	0	1	2
OG0007435	0	1	0	1	2
OG0007436	0	1	0	1	2
OG0007437	0	1	1	0	2
OG0007438	0	2	0	0	2
OG0007439	0	1	1	0	2
OG0007440	0	1	1	0	2
OG0007441	0	1	0	1	2
OG0007442	0	1	1	0	2
OG0007443	0	1	1	0	2
OG0007444	0	1	0	1	2
OG0007445	0	1	1	0	2
OG0007446	0	1	1	0	2
OG0007447	0	1	0	1	2
OG0007448	0	1	0	1	2
OG0007449	0	1	1	0	2
OG0007450	0	1	0	1	2
OG0007451	0	1	0	1	2
OG0007452	0	1	0	1	2
OG0007453	0	1	1	0	2
OG0007454	0	1	1	0	2
OG0007455	0	1	0	1	2
OG0007456	0	1	1	0	2
OG0007457	0	2	0	0	2
OG0007458	0	1	0	1	2
OG0007459	0	1	1	0	2
OG0007460	0	1	0	1	2
OG0007461	0	1	0	1	2
OG0007462	0	1	0	1	2
OG0007463	0	1	1	0	2
OG0007464	0	1	1	0	2
OG0007465	0	1	1	0	2
OG0007466	0	1	0	1	2
OG0007467	0	1	1	0	2
OG0007468	0	1	1	0	2
OG0007469	0	1	0	1	2
OG0007470	0	1	1	0	2
OG0007471	0	1	1	0	2
OG0007472	0	1	0	1	2
OG0007473	0	1	1	0	2
OG0007474	0	1	0	1	2
OG0007475	0	1	0	1	2
OG0007476	0	1	0	1	2
OG0007477	0	1	0	1	2
OG0007478	0	1	0	1	2
OG0007479	0	1	1	0	2
OG0007480	0	1	1	0	2
OG0007481	0	1	1	0	2
OG0007482	0	1	1	0	2
OG0007483	0	1	1	0	2
OG0007484	0	1	0	1	2
OG0007485	0	1	1	0	2
OG0007486	0	1	1	0	2
OG0007487	0	1	1	0	2
OG0007488	0	1	1	0	2
OG0007489	0	1	0	1	2
OG0007490	0	1	1	0	2
OG0007491	0	1	1	0	2
OG0007492	0	2	0	0	2
OG0007493	0	1	1	0	2
OG0007494	0	1	1	0	2
OG0007495	0	1	1	0	2
OG0007496	0	1	1	0	2
OG0007497	0	1	0	1	2
OG0007498	0	1	1	0	2
OG0007499	0	2	0	0	2
OG0007500	0	1	1	0	2
OG0007501	0	1	0	1	2
OG0007502	0	1	0	1	2
OG0007503	0	1	0	1	2
OG0007504	0	1	0	1	2
OG0007505	0	1	1	0	2
OG0007506	0	1	0	1	2
OG0007507	0	1	1	0	2
OG0007508	0	1	1	0	2
OG0007509	0	1	1	0	2
OG0007510	0	1	0	1	2
OG0007511	0	1	0	1	2
OG0007512	0	1	0	1	2
OG0007513	0	2	0	0	2
OG0007514	0	1	0	1	2
OG0007515	0	1	1	0	2
OG0007516	0	1	0	1	2
OG0007517	0	1	0	1	2
OG0007518	0	1	0	1	2
OG0007519	0	1	1	0	2
OG0007520	0	1	0	1	2
OG0007521	0	2	0	0	2
OG0007522	0	2	0	0	2
OG0007523	0	2	0	0	2
OG0007524	0	2	0	0	2
OG0007525	0	2	0	0	2
OG0007526	0	2	0	0	2
OG0007527	0	1	0	1	2
OG0007528	0	1	0	1	2
OG0007529	0	1	0	1	2
OG0007530	0	1	0	1	2
OG0007531	0	1	0	1	2
OG0007532	0	1	1	0	2
OG0007533	0	2	0	0	2
OG0007534	0	1	1	0	2
OG0007535	0	1	0	1	2
OG0007536	0	1	0	1	2
OG0007537	0	1	1	0	2
OG0007538	0	1	1	0	2
OG0007539	0	1	0	1	2
OG0007540	0	1	1	0	2
OG0007541	0	1	0	1	2
OG0007542	0	1	0	1	2
OG0007543	0	1	0	1	2
OG0007544	0	1	1	0	2
OG0007545	0	1	1	0	2
OG0007546	0	1	0	1	2
OG0007547	0	1	0	1	2
OG0007548	0	1	0	1	2
OG0007549	0	1	0	1	2
OG0007550	0	1	0	1	2
OG0007551	0	1	1	0	2
OG0007552	0	1	1	0	2
OG0007553	0	1	1	0	2
OG0007554	0	1	1	0	2
OG0007555	0	1	1	0	2
OG0007556	0	1	0	1	2
OG0007557	0	1	1	0	2
OG0007558	0	1	1	0	2
OG0007559	0	1	1	0	2
OG0007560	0	1	0	1	2
OG0007561	0	1	0	1	2
OG0007562	0	2	0	0	2
OG0007563	0	1	0	1	2
OG0007564	0	1	0	1	2
OG0007565	0	1	1	0	2
OG0007566	0	2	0	0	2
OG0007567	0	2	0	0	2
OG0007568	0	2	0	0	2
OG0007569	0	1	1	0	2
OG0007570	0	1	0	1	2
OG0007571	0	1	0	1	2
OG0007572	0	1	1	0	2
OG0007573	0	1	1	0	2
OG0007574	0	1	1	0	2
OG0007575	0	1	1	0	2
OG0007576	0	1	1	0	2
OG0007577	0	1	0	1	2
OG0007578	0	1	1	0	2
OG0007579	0	1	0	1	2
OG0007580	0	1	0	1	2
OG0007581	0	1	1	0	2
OG0007582	0	1	1	0	2
OG0007583	0	1	0	1	2
OG0007584	0	1	0	1	2
OG0007585	0	1	0	1	2
OG0007586	0	1	0	1	2
OG0007587	0	1	0	1	2
OG0007588	0	1	0	1	2
OG0007589	0	1	1	0	2
OG0007590	0	1	1	0	2
OG0007591	0	1	1	0	2
OG0007592	0	1	0	1	2
OG0007593	0	1	0	1	2
OG0007594	0	1	1	0	2
OG0007595	0	1	1	0	2
OG0007596	0	1	1	0	2
OG0007597	0	1	0	1	2
OG0007598	0	2	0	0	2
OG0007599	0	2	0	0	2
OG0007600	0	1	1	0	2
OG0007601	0	1	1	0	2
OG0007602	0	1	1	0	2
OG0007603	0	1	1	0	2
OG0007604	0	1	1	0	2
OG0007605	0	1	1	0	2
OG0007606	0	1	0	1	2
OG0007607	0	1	1	0	2
OG0007608	0	1	1	0	2
OG0007609	0	1	0	1	2
OG0007610	0	1	0	1	2
OG0007611	0	1	1	0	2
OG0007612	0	2	0	0	2
OG0007613	0	1	0	1	2
OG0007614	0	1	1	0	2
OG0007615	0	1	1	0	2
OG0007616	0	1	1	0	2
OG0007617	0	1	0	1	2
OG0007618	0	1	1	0	2
OG0007619	0	1	0	1	2
OG0007620	0	1	0	1	2
OG0007621	0	1	1	0	2
OG0007622	0	1	0	1	2
OG0007623	0	2	0	0	2
OG0007624	0	1	0	1	2
OG0007625	0	1	0	1	2
OG0007626	0	1	1	0	2
OG0007627	0	1	1	0	2
OG0007628	0	2	0	0	2
OG0007629	0	1	1	0	2
OG0007630	0	1	1	0	2
OG0007631	0	1	1	0	2
OG0007632	0	1	1	0	2
OG0007633	0	1	0	1	2
OG0007634	0	1	1	0	2
OG0007635	0	1	1	0	2
OG0007636	0	1	0	1	2
OG0007637	0	1	1	0	2
OG0007638	0	1	1	0	2
OG0007639	0	1	0	1	2
OG0007640	0	1	1	0	2
OG0007641	0	1	0	1	2
OG0007642	0	1	0	1	2
OG0007643	0	1	1	0	2
OG0007644	0	1	1	0	2
OG0007645	0	1	1	0	2
OG0007646	0	1	1	0	2
OG0007647	0	1	0	1	2
OG0007648	0	1	1	0	2
OG0007649	0	1	1	0	2
OG0007650	0	1	1	0	2
OG0007651	0	1	1	0	2
OG0007652	0	1	0	1	2
OG0007653	0	1	1	0	2
OG0007654	0	1	1	0	2
OG0007655	0	1	0	1	2
OG0007656	0	1	1	0	2
OG0007657	0	1	1	0	2
OG0007658	0	1	1	0	2
OG0007659	0	1	1	0	2
OG0007660	0	1	1	0	2
OG0007661	0	1	1	0	2
OG0007662	0	1	1	0	2
OG0007663	0	2	0	0	2
OG0007664	0	1	1	0	2
OG0007665	0	1	1	0	2
OG0007666	0	1	1	0	2
OG0007667	0	1	1	0	2
OG0007668	0	1	0	1	2
OG0007669	0	1	1	0	2
OG0007670	0	1	1	0	2
OG0007671	0	1	0	1	2
OG0007672	0	1	0	1	2
OG0007673	0	1	0	1	2
OG0007674	0	1	1	0	2
OG0007675	0	1	0	1	2
OG0007676	0	1	1	0	2
OG0007677	0	1	0	1	2
OG0007678	0	1	1	0	2
OG0007679	0	1	0	1	2
OG0007680	0	1	1	0	2
OG0007681	0	1	0	1	2
OG0007682	0	1	0	1	2
OG0007683	0	1	0	1	2
OG0007684	0	1	1	0	2
OG0007685	0	1	1	0	2
OG0007686	0	1	1	0	2
OG0007687	0	1	1	0	2
OG0007688	0	1	1	0	2
OG0007689	0	1	0	1	2
OG0007690	0	1	1	0	2
OG0007691	0	1	1	0	2
OG0007692	0	1	1	0	2
OG0007693	0	1	1	0	2
OG0007694	0	1	1	0	2
OG0007695	0	2	0	0	2
OG0007696	0	2	0	0	2
OG0007697	0	2	0	0	2
OG0007698	0	2	0	0	2
OG0007699	0	2	0	0	2
OG0007700	0	1	1	0	2
OG0007701	0	1	0	1	2
OG0007702	0	1	1	0	2
OG0007703	0	1	1	0	2
OG0007704	0	1	1	0	2
OG0007705	0	1	1	0	2
OG0007706	0	1	0	1	2
OG0007707	0	1	0	1	2
OG0007708	0	1	1	0	2
OG0007709	0	1	1	0	2
OG0007710	0	1	0	1	2
OG0007711	0	1	0	1	2
OG0007712	0	1	1	0	2
OG0007713	0	1	1	0	2
OG0007714	0	1	0	1	2
OG0007715	0	1	0	1	2
OG0007716	0	1	1	0	2
OG0007717	0	1	1	0	2
OG0007718	0	1	0	1	2
OG0007719	0	1	0	1	2
OG0007720	0	1	1	0	2
OG0007721	0	2	0	0	2
OG0007722	0	2	0	0	2
OG0007723	0	1	1	0	2
OG0007724	0	1	0	1	2
OG0007725	0	1	1	0	2
OG0007726	0	2	0	0	2
OG0007727	0	1	1	0	2
OG0007728	0	1	0	1	2
OG0007729	0	1	1	0	2
OG0007730	0	1	0	1	2
OG0007731	0	1	0	1	2
OG0007732	0	1	1	0	2
OG0007733	0	1	0	1	2
OG0007734	0	1	1	0	2
OG0007735	0	1	1	0	2
OG0007736	0	1	0	1	2
OG0007737	0	2	0	0	2
OG0007738	0	1	0	1	2
OG0007739	0	1	0	1	2
OG0007740	0	1	1	0	2
OG0007741	0	2	0	0	2
OG0007742	0	2	0	0	2
OG0007743	0	1	1	0	2
OG0007744	0	1	0	1	2
OG0007745	0	1	0	1	2
OG0007746	0	1	1	0	2
OG0007747	0	2	0	0	2
OG0007748	0	1	1	0	2
OG0007749	0	1	0	1	2
OG0007750	0	2	0	0	2
OG0007751	0	1	0	1	2
OG0007752	0	2	0	0	2
OG0007753	0	1	0	1	2
OG0007754	0	1	0	1	2
OG0007755	0	1	0	1	2
OG0007756	0	1	1	0	2
OG0007757	0	1	0	1	2
OG0007758	0	1	0	1	2
OG0007759	0	1	0	1	2
OG0007760	0	1	0	1	2
OG0007761	0	1	1	0	2
OG0007762	0	1	1	0	2
OG0007763	0	1	0	1	2
OG0007764	0	1	0	1	2
OG0007765	0	1	0	1	2
OG0007766	0	1	1	0	2
OG0007767	0	1	1	0	2
OG0007768	0	1	1	0	2
OG0007769	0	1	0	1	2
OG0007770	0	1	0	1	2
OG0007771	0	1	0	1	2
OG0007772	0	1	0	1	2
OG0007773	0	1	0	1	2
OG0007774	0	1	1	0	2
OG0007775	0	1	1	0	2
OG0007776	0	1	1	0	2
OG0007777	0	1	0	1	2
OG0007778	0	1	1	0	2
OG0007779	0	1	1	0	2
OG0007780	0	1	0	1	2
OG0007781	0	1	1	0	2
OG0007782	0	1	1	0	2
OG0007783	0	1	1	0	2
OG0007784	0	2	0	0	2
OG0007785	0	1	1	0	2
OG0007786	0	1	1	0	2
OG0007787	0	1	1	0	2
OG0007788	0	1	1	0	2
OG0007789	0	1	1	0	2
OG0007790	0	1	1	0	2
OG0007791	0	1	0	1	2
OG0007792	0	1	0	1	2
OG0007793	0	1	1	0	2
OG0007794	0	1	0	1	2
OG0007795	0	1	0	1	2
OG0007796	0	1	0	1	2
OG0007797	0	1	1	0	2
OG0007798	0	1	1	0	2
OG0007799	0	1	1	0	2
OG0007800	0	1	1	0	2
OG0007801	0	1	1	0	2
OG0007802	0	1	1	0	2
OG0007803	0	1	0	1	2
OG0007804	0	1	0	1	2
OG0007805	0	1	0	1	2
OG0007806	0	1	1	0	2
OG0007807	0	1	1	0	2
OG0007808	0	1	1	0	2
OG0007809	0	1	0	1	2
OG0007810	0	1	1	0	2
OG0007811	0	1	1	0	2
OG0007812	0	1	1	0	2
OG0007813	0	1	0	1	2
OG0007814	0	1	0	1	2
OG0007815	0	1	0	1	2
OG0007816	0	1	1	0	2
OG0007817	0	1	0	1	2
OG0007818	0	1	1	0	2
OG0007819	0	1	1	0	2
OG0007820	0	1	1	0	2
OG0007821	0	1	0	1	2
OG0007822	0	1	0	1	2
OG0007823	0	1	1	0	2
OG0007824	0	1	1	0	2
OG0007825	0	1	0	1	2
OG0007826	0	1	1	0	2
OG0007827	0	2	0	0	2
OG0007828	0	1	1	0	2
OG0007829	0	1	0	1	2
OG0007830	0	1	1	0	2
OG0007831	0	1	0	1	2
OG0007832	0	1	0	1	2
OG0007833	0	1	1	0	2
OG0007834	0	1	1	0	2
OG0007835	0	1	1	0	2
OG0007836	0	2	0	0	2
OG0007837	0	2	0	0	2
OG0007838	0	2	0	0	2
OG0007839	0	1	0	1	2
OG0007840	0	1	1	0	2
OG0007841	0	1	0	1	2
OG0007842	0	1	1	0	2
OG0007843	0	1	1	0	2
OG0007844	0	2	0	0	2
OG0007845	0	1	0	1	2
OG0007846	0	1	1	0	2
OG0007847	0	1	1	0	2
OG0007848	0	1	0	1	2
OG0007849	0	1	0	1	2
OG0007850	0	1	0	1	2
OG0007851	0	1	0	1	2
OG0007852	0	1	1	0	2
OG0007853	0	1	0	1	2
OG0007854	0	1	0	1	2
OG0007855	0	1	0	1	2
OG0007856	0	1	0	1	2
OG0007857	0	1	0	1	2
OG0007858	0	1	0	1	2
OG0007859	0	1	1	0	2
OG0007860	0	1	1	0	2
OG0007861	0	1	0	1	2
OG0007862	0	1	1	0	2
OG0007863	0	1	0	1	2
OG0007864	0	1	0	1	2
OG0007865	0	1	0	1	2
OG0007866	0	1	0	1	2
OG0007867	0	1	1	0	2
OG0007868	0	1	1	0	2
OG0007869	0	1	1	0	2
OG0007870	0	1	0	1	2
OG0007871	0	1	0	1	2
OG0007872	0	2	0	0	2
OG0007873	0	2	0	0	2
OG0007874	0	2	0	0	2
OG0007875	0	2	0	0	2
OG0007876	0	1	1	0	2
OG0007877	0	1	0	1	2
OG0007878	0	1	1	0	2
OG0007879	0	1	1	0	2
OG0007880	0	1	0	1	2
OG0007881	0	1	0	1	2
OG0007882	0	1	1	0	2
OG0007883	0	1	0	1	2
OG0007884	0	1	1	0	2
OG0007885	0	2	0	0	2
OG0007886	0	1	0	1	2
OG0007887	0	1	0	1	2
OG0007888	0	1	1	0	2
OG0007889	0	1	0	1	2
OG0007890	0	1	1	0	2
OG0007891	0	1	0	1	2
OG0007892	0	1	0	1	2
OG0007893	0	1	0	1	2
OG0007894	0	1	0	1	2
OG0007895	0	1	0	1	2
OG0007896	0	1	0	1	2
OG0007897	0	1	0	1	2
OG0007898	0	1	1	0	2
OG0007899	0	1	0	1	2
OG0007900	0	1	1	0	2
OG0007901	0	1	1	0	2
OG0007902	0	1	1	0	2
OG0007903	0	1	1	0	2
OG0007904	0	1	0	1	2
OG0007905	0	1	1	0	2
OG0007906	0	1	1	0	2
OG0007907	0	1	1	0	2
OG0007908	0	1	1	0	2
OG0007909	0	1	1	0	2
OG0007910	0	1	0	1	2
OG0007911	0	1	0	1	2
OG0007912	0	1	0	1	2
OG0007913	0	1	0	1	2
OG0007914	0	1	1	0	2
OG0007915	0	1	0	1	2
OG0007916	0	1	1	0	2
OG0007917	0	1	1	0	2
OG0007918	0	1	1	0	2
OG0007919	0	1	1	0	2
OG0007920	0	1	0	1	2
OG0007921	0	1	1	0	2
OG0007922	0	1	0	1	2
OG0007923	0	1	0	1	2
OG0007924	0	1	0	1	2
OG0007925	0	1	1	0	2
OG0007926	0	1	1	0	2
OG0007927	0	1	0	1	2
OG0007928	0	2	0	0	2
OG0007929	0	1	1	0	2
OG0007930	0	1	1	0	2
OG0007931	0	1	0	1	2
OG0007932	0	1	1	0	2
OG0007933	0	1	0	1	2
OG0007934	0	1	1	0	2
OG0007935	0	1	0	1	2
OG0007936	0	1	1	0	2
OG0007937	0	1	0	1	2
OG0007938	0	1	0	1	2
OG0007939	0	1	1	0	2
OG0007940	0	1	1	0	2
OG0007941	0	1	1	0	2
OG0007942	0	1	1	0	2
OG0007943	0	1	1	0	2
OG0007944	0	1	0	1	2
OG0007945	0	1	0	1	2
OG0007946	0	1	1	0	2
OG0007947	0	1	0	1	2
OG0007948	0	1	0	1	2
OG0007949	0	1	1	0	2
OG0007950	0	1	1	0	2
OG0007951	0	1	0	1	2
OG0007952	0	1	0	1	2
OG0007953	0	1	0	1	2
OG0007954	0	1	0	1	2
OG0007955	0	1	0	1	2
OG0007956	0	1	1	0	2
OG0007957	0	1	1	0	2
OG0007958	0	1	0	1	2
OG0007959	0	1	0	1	2
OG0007960	0	1	1	0	2
OG0007961	0	1	1	0	2
OG0007962	0	1	0	1	2
OG0007963	0	1	1	0	2
OG0007964	0	1	1	0	2
OG0007965	0	1	0	1	2
OG0007966	0	1	0	1	2
OG0007967	0	1	1	0	2
OG0007968	0	1	1	0	2
OG0007969	0	1	1	0	2
OG0007970	0	2	0	0	2
OG0007971	0	1	0	1	2
OG0007972	0	1	0	1	2
OG0007973	0	1	1	0	2
OG0007974	0	1	0	1	2
OG0007975	0	1	0	1	2
OG0007976	0	1	1	0	2
OG0007977	0	1	1	0	2
OG0007978	0	1	0	1	2
OG0007979	0	1	0	1	2
OG0007980	0	1	0	1	2
OG0007981	0	1	0	1	2
OG0007982	0	1	0	1	2
OG0007983	0	1	1	0	2
OG0007984	0	1	1	0	2
OG0007985	0	1	0	1	2
OG0007986	0	1	0	1	2
OG0007987	0	1	0	1	2
OG0007988	0	1	1	0	2
OG0007989	0	1	0	1	2
OG0007990	0	1	1	0	2
OG0007991	0	1	0	1	2
OG0007992	0	1	1	0	2
OG0007993	0	1	0	1	2
OG0007994	0	1	0	1	2
OG0007995	0	1	0	1	2
OG0007996	0	1	0	1	2
OG0007997	0	1	0	1	2
OG0007998	0	1	0	1	2
OG0007999	0	1	0	1	2
OG0008000	0	1	1	0	2
OG0008001	0	1	1	0	2
OG0008002	0	1	1	0	2
OG0008003	0	1	1	0	2
OG0008004	0	1	1	0	2
OG0008005	0	1	1	0	2
OG0008006	0	1	0	1	2
OG0008007	0	1	1	0	2
OG0008008	0	1	1	0	2
OG0008009	0	1	1	0	2
OG0008010	0	1	0	1	2
OG0008011	0	1	0	1	2
OG0008012	0	1	1	0	2
OG0008013	0	1	0	1	2
OG0008014	0	1	1	0	2
OG0008015	0	1	0	1	2
OG0008016	0	1	0	1	2
OG0008017	0	1	1	0	2
OG0008018	0	1	1	0	2
OG0008019	0	1	1	0	2
OG0008020	0	1	0	1	2
OG0008021	0	1	0	1	2
OG0008022	0	1	1	0	2
OG0008023	0	1	1	0	2
OG0008024	0	1	0	1	2
OG0008025	0	1	1	0	2
OG0008026	0	1	1	0	2
OG0008027	0	1	0	1	2
OG0008028	0	1	1	0	2
OG0008029	0	1	0	1	2
OG0008030	0	2	0	0	2
OG0008031	0	1	0	1	2
OG0008032	0	1	1	0	2
OG0008033	0	1	0	1	2
OG0008034	0	1	0	1	2
OG0008035	0	1	1	0	2
OG0008036	0	1	0	1	2
OG0008037	0	1	0	1	2
OG0008038	0	1	1	0	2
OG0008039	0	2	0	0	2
OG0008040	0	1	0	1	2
OG0008041	0	1	1	0	2
OG0008042	0	1	1	0	2
OG0008043	0	1	0	1	2
OG0008044	0	1	0	1	2
OG0008045	0	1	0	1	2
OG0008046	0	1	0	1	2
OG0008047	0	1	0	1	2
OG0008048	0	1	0	1	2
OG0008049	0	1	0	1	2
OG0008050	0	1	1	0	2
OG0008051	0	1	1	0	2
OG0008052	0	1	0	1	2
OG0008053	0	1	1	0	2
OG0008054	0	1	1	0	2
OG0008055	0	1	0	1	2
OG0008056	0	1	0	1	2
OG0008057	0	1	0	1	2
OG0008058	0	1	0	1	2
OG0008059	0	1	0	1	2
OG0008060	0	2	0	0	2
OG0008061	0	1	1	0	2
OG0008062	0	1	1	0	2
OG0008063	0	1	0	1	2
OG0008064	0	1	0	1	2
OG0008065	0	1	0	1	2
OG0008066	0	1	1	0	2
OG0008067	0	1	0	1	2
OG0008068	0	1	0	1	2
OG0008069	0	1	1	0	2
OG0008070	0	1	0	1	2
OG0008071	0	1	1	0	2
OG0008072	0	1	0	1	2
OG0008073	0	1	1	0	2
OG0008074	0	1	0	1	2
OG0008075	0	1	0	1	2
OG0008076	0	1	0	1	2
OG0008077	0	1	1	0	2
OG0008078	0	1	1	0	2
OG0008079	0	1	1	0	2
OG0008080	0	1	1	0	2
OG0008081	0	1	1	0	2
OG0008082	0	1	1	0	2
OG0008083	0	1	1	0	2
OG0008084	0	1	0	1	2
OG0008085	0	1	1	0	2
OG0008086	0	1	0	1	2
OG0008087	0	1	0	1	2
OG0008088	0	1	1	0	2
OG0008089	0	1	1	0	2
OG0008090	0	1	0	1	2
OG0008091	0	1	0	1	2
OG0008092	0	1	0	1	2
OG0008093	0	1	0	1	2
OG0008094	0	1	0	1	2
OG0008095	0	1	1	0	2
OG0008096	0	1	0	1	2
OG0008097	0	1	1	0	2
OG0008098	0	1	0	1	2
OG0008099	0	1	0	1	2
OG0008100	0	1	0	1	2
OG0008101	0	1	1	0	2
OG0008102	0	1	0	1	2
OG0008103	0	1	1	0	2
OG0008104	0	1	0	1	2
OG0008105	0	1	0	1	2
OG0008106	0	1	1	0	2
OG0008107	0	1	1	0	2
OG0008108	0	2	0	0	2
OG0008109	0	1	1	0	2
OG0008110	0	1	1	0	2
OG0008111	0	1	0	1	2
OG0008112	0	1	1	0	2
OG0008113	0	1	0	1	2
OG0008114	0	1	1	0	2
OG0008115	0	1	1	0	2
OG0008116	0	1	0	1	2
OG0008117	0	1	1	0	2
OG0008118	0	1	1	0	2
OG0008119	0	1	1	0	2
OG0008120	0	1	1	0	2
OG0008121	0	1	0	1	2
OG0008122	0	1	1	0	2
OG0008123	0	1	0	1	2
OG0008124	0	1	0	1	2
OG0008125	0	1	1	0	2
OG0008126	0	1	1	0	2
OG0008127	0	1	1	0	2
OG0008128	0	1	1	0	2
OG0008129	0	1	0	1	2
OG0008130	0	1	1	0	2
OG0008131	0	1	0	1	2
OG0008132	0	1	1	0	2
OG0008133	0	1	1	0	2
OG0008134	0	1	1	0	2
OG0008135	0	1	0	1	2
OG0008136	0	1	1	0	2
OG0008137	0	1	1	0	2
OG0008138	0	1	1	0	2
OG0008139	0	1	1	0	2
OG0008140	0	1	0	1	2
OG0008141	0	1	1	0	2
OG0008142	0	1	0	1	2
OG0008143	0	1	0	1	2
OG0008144	0	1	0	1	2
OG0008145	0	1	1	0	2
OG0008146	0	1	1	0	2
OG0008147	0	1	1	0	2
OG0008148	0	1	1	0	2
OG0008149	0	1	1	0	2
OG0008150	0	1	1	0	2
OG0008151	0	1	1	0	2
OG0008152	0	1	0	1	2
OG0008153	0	2	0	0	2
OG0008154	0	1	1	0	2
OG0008155	0	1	1	0	2
OG0008156	0	1	0	1	2
OG0008157	0	1	1	0	2
OG0008158	0	1	1	0	2
OG0008159	0	1	1	0	2
OG0008160	0	1	0	1	2
OG0008161	0	1	1	0	2
OG0008162	0	1	0	1	2
OG0008163	0	1	1	0	2
OG0008164	0	1	0	1	2
OG0008165	0	1	1	0	2
OG0008166	0	1	0	1	2
OG0008167	0	1	1	0	2
OG0008168	0	1	1	0	2
OG0008169	0	1	1	0	2
OG0008170	0	1	0	1	2
OG0008171	0	1	0	1	2
OG0008172	0	2	0	0	2
OG0008173	0	1	1	0	2
OG0008174	0	1	0	1	2
OG0008175	0	1	0	1	2
OG0008176	0	1	0	1	2
OG0008177	0	2	0	0	2
OG0008178	0	1	1	0	2
OG0008179	0	1	1	0	2
OG0008180	0	1	0	1	2
OG0008181	0	1	0	1	2
OG0008182	0	1	1	0	2
OG0008183	0	1	1	0	2
OG0008184	0	1	1	0	2
OG0008185	0	1	0	1	2
OG0008186	0	1	0	1	2
OG0008187	0	1	0	1	2
OG0008188	0	1	0	1	2
OG0008189	0	1	1	0	2
OG0008190	0	1	0	1	2
OG0008191	0	1	1	0	2
OG0008192	0	1	1	0	2
OG0008193	0	1	0	1	2
OG0008194	0	1	1	0	2
OG0008195	0	1	0	1	2
OG0008196	0	1	0	1	2
OG0008197	0	1	0	1	2
OG0008198	0	1	0	1	2
OG0008199	0	1	0	1	2
OG0008200	0	1	1	0	2
OG0008201	0	1	1	0	2
OG0008202	0	1	1	0	2
OG0008203	0	1	1	0	2
OG0008204	0	1	1	0	2
OG0008205	0	1	0	1	2
OG0008206	0	1	0	1	2
OG0008207	0	2	0	0	2
OG0008208	0	1	0	1	2
OG0008209	0	1	0	1	2
OG0008210	0	1	1	0	2
OG0008211	0	1	1	0	2
OG0008212	0	1	1	0	2
OG0008213	0	1	1	0	2
OG0008214	0	1	1	0	2
OG0008215	0	1	1	0	2
OG0008216	0	1	0	1	2
OG0008217	0	1	0	1	2
OG0008218	0	1	1	0	2
OG0008219	0	1	0	1	2
OG0008220	0	1	1	0	2
OG0008221	0	1	1	0	2
OG0008222	0	1	0	1	2
OG0008223	0	1	0	1	2
OG0008224	0	1	1	0	2
OG0008225	0	1	1	0	2
OG0008226	0	1	1	0	2
OG0008227	0	1	0	1	2
OG0008228	0	1	0	1	2
OG0008229	0	1	0	1	2
OG0008230	0	1	1	0	2
OG0008231	0	1	0	1	2
OG0008232	0	1	0	1	2
OG0008233	0	1	1	0	2
OG0008234	0	1	0	1	2
OG0008235	0	1	1	0	2
OG0008236	0	1	1	0	2
OG0008237	0	1	0	1	2
OG0008238	0	1	1	0	2
OG0008239	0	1	0	1	2
OG0008240	0	1	1	0	2
OG0008241	0	1	1	0	2
OG0008242	0	1	0	1	2
OG0008243	0	1	0	1	2
OG0008244	0	1	0	1	2
OG0008245	0	1	0	1	2
OG0008246	0	1	0	1	2
OG0008247	0	1	1	0	2
OG0008248	0	1	1	0	2
OG0008249	0	1	1	0	2
OG0008250	0	1	1	0	2
OG0008251	0	1	0	1	2
OG0008252	0	1	1	0	2
OG0008253	0	1	1	0	2
OG0008254	0	1	1	0	2
OG0008255	0	1	0	1	2
OG0008256	0	1	0	1	2
OG0008257	0	1	1	0	2
OG0008258	0	1	1	0	2
OG0008259	0	1	1	0	2
OG0008260	0	1	1	0	2
OG0008261	0	1	0	1	2
OG0008262	0	1	0	1	2
OG0008263	0	1	1	0	2
OG0008264	0	1	0	1	2
OG0008265	0	1	0	1	2
OG0008266	0	1	1	0	2
OG0008267	0	1	1	0	2
OG0008268	0	1	0	1	2
OG0008269	0	1	1	0	2
OG0008270	0	1	0	1	2
OG0008271	0	1	1	0	2
OG0008272	0	1	1	0	2
OG0008273	0	1	1	0	2
OG0008274	0	1	1	0	2
OG0008275	0	1	1	0	2
OG0008276	0	1	1	0	2
OG0008277	0	1	0	1	2
OG0008278	0	1	1	0	2
OG0008279	0	1	0	1	2
OG0008280	0	1	1	0	2
OG0008281	0	1	0	1	2
OG0008282	0	1	1	0	2
OG0008283	0	1	1	0	2
OG0008284	0	1	0	1	2
OG0008285	0	1	1	0	2
OG0008286	0	1	0	1	2
OG0008287	0	2	0	0	2
OG0008288	0	1	0	1	2
OG0008289	0	1	0	1	2
OG0008290	0	1	0	1	2
OG0008291	0	1	1	0	2
OG0008292	0	1	1	0	2
OG0008293	0	1	0	1	2
OG0008294	0	1	1	0	2
OG0008295	0	1	1	0	2
OG0008296	0	1	1	0	2
OG0008297	0	1	1	0	2
OG0008298	0	1	0	1	2
OG0008299	0	1	0	1	2
OG0008300	0	1	1	0	2
OG0008301	0	1	1	0	2
OG0008302	0	1	1	0	2
OG0008303	0	1	1	0	2
OG0008304	0	1	0	1	2
OG0008305	0	1	1	0	2
OG0008306	0	1	0	1	2
OG0008307	0	1	1	0	2
OG0008308	0	1	0	1	2
OG0008309	0	1	0	1	2
OG0008310	0	1	1	0	2
OG0008311	0	1	0	1	2
OG0008312	0	1	1	0	2
OG0008313	0	1	0	1	2
OG0008314	0	1	1	0	2
OG0008315	0	1	1	0	2
OG0008316	0	1	1	0	2
OG0008317	0	1	0	1	2
OG0008318	0	1	0	1	2
OG0008319	0	1	1	0	2
OG0008320	0	1	0	1	2
OG0008321	0	1	0	1	2
OG0008322	0	1	0	1	2
OG0008323	0	1	0	1	2
OG0008324	0	1	0	1	2
OG0008325	0	1	0	1	2
OG0008326	0	1	1	0	2
OG0008327	0	1	0	1	2
OG0008328	0	1	1	0	2
OG0008329	0	1	1	0	2
OG0008330	0	1	1	0	2
OG0008331	0	1	1	0	2
OG0008332	0	1	1	0	2
OG0008333	0	1	1	0	2
OG0008334	0	1	1	0	2
OG0008335	0	1	1	0	2
OG0008336	0	1	1	0	2
OG0008337	0	1	1	0	2
OG0008338	0	1	0	1	2
OG0008339	0	1	1	0	2
OG0008340	0	1	1	0	2
OG0008341	0	1	0	1	2
OG0008342	0	1	0	1	2
OG0008343	0	1	1	0	2
OG0008344	0	1	0	1	2
OG0008345	0	1	1	0	2
OG0008346	0	1	1	0	2
OG0008347	0	1	1	0	2
OG0008348	0	1	1	0	2
OG0008349	0	1	0	1	2
OG0008350	0	1	0	1	2
OG0008351	0	1	1	0	2
OG0008352	0	1	0	1	2
OG0008353	0	1	0	1	2
OG0008354	0	1	1	0	2
OG0008355	0	1	1	0	2
OG0008356	0	1	1	0	2
OG0008357	0	1	1	0	2
OG0008358	0	1	1	0	2
OG0008359	0	1	1	0	2
OG0008360	0	1	0	1	2
OG0008361	0	1	0	1	2
OG0008362	0	1	0	1	2
OG0008363	0	1	1	0	2
OG0008364	0	1	1	0	2
OG0008365	0	1	1	0	2
OG0008366	0	1	1	0	2
OG0008367	0	1	1	0	2
OG0008368	0	1	1	0	2
OG0008369	0	1	1	0	2
OG0008370	0	1	1	0	2
OG0008371	0	1	1	0	2
OG0008372	0	1	1	0	2
OG0008373	0	1	0	1	2
OG0008374	0	1	1	0	2
OG0008375	0	1	1	0	2
OG0008376	0	2	0	0	2
OG0008377	0	1	0	1	2
OG0008378	0	1	1	0	2
OG0008379	0	1	0	1	2
OG0008380	0	1	0	1	2
OG0008381	0	1	1	0	2
OG0008382	0	1	1	0	2
OG0008383	0	1	1	0	2
OG0008384	0	1	0	1	2
OG0008385	0	1	0	1	2
OG0008386	0	1	0	1	2
OG0008387	0	1	1	0	2
OG0008388	0	1	0	1	2
OG0008389	0	1	0	1	2
OG0008390	0	1	0	1	2
OG0008391	0	1	0	1	2
OG0008392	0	1	1	0	2
OG0008393	0	1	0	1	2
OG0008394	0	1	1	0	2
OG0008395	0	1	1	0	2
OG0008396	0	1	1	0	2
OG0008397	0	1	1	0	2
OG0008398	0	1	0	1	2
OG0008399	0	1	1	0	2
OG0008400	0	1	1	0	2
OG0008401	0	1	1	0	2
OG0008402	0	1	1	0	2
OG0008403	0	1	0	1	2
OG0008404	0	1	0	1	2
OG0008405	0	1	1	0	2
OG0008406	0	1	0	1	2
OG0008407	0	1	0	1	2
OG0008408	0	1	0	1	2
OG0008409	0	1	0	1	2
OG0008410	0	1	0	1	2
OG0008411	0	1	0	1	2
OG0008412	0	1	1	0	2
OG0008413	0	1	1	0	2
OG0008414	0	1	0	1	2
OG0008415	0	1	1	0	2
OG0008416	0	1	0	1	2
OG0008417	0	1	1	0	2
OG0008418	0	1	0	1	2
OG0008419	0	1	0	1	2
OG0008420	0	1	0	1	2
OG0008421	0	1	1	0	2
OG0008422	0	1	0	1	2
OG0008423	0	1	1	0	2
OG0008424	0	1	1	0	2
OG0008425	0	1	1	0	2
OG0008426	0	1	0	1	2
OG0008427	0	1	1	0	2
OG0008428	0	1	1	0	2
OG0008429	0	1	0	1	2
OG0008430	0	1	1	0	2
OG0008431	0	1	1	0	2
OG0008432	0	2	0	0	2
OG0008433	0	1	0	1	2
OG0008434	0	1	0	1	2
OG0008435	0	1	0	1	2
OG0008436	0	1	1	0	2
OG0008437	0	1	1	0	2
OG0008438	0	1	0	1	2
OG0008439	0	1	1	0	2
OG0008440	0	1	1	0	2
OG0008441	0	1	1	0	2
OG0008442	0	1	0	1	2
OG0008443	0	1	1	0	2
OG0008444	0	1	0	1	2
OG0008445	0	1	1	0	2
OG0008446	0	1	1	0	2
OG0008447	0	1	0	1	2
OG0008448	0	1	1	0	2
OG0008449	0	1	1	0	2
OG0008450	0	1	1	0	2
OG0008451	0	1	0	1	2
OG0008452	0	1	0	1	2
OG0008453	0	1	0	1	2
OG0008454	0	1	1	0	2
OG0008455	0	1	1	0	2
OG0008456	0	1	0	1	2
OG0008457	0	1	0	1	2
OG0008458	0	1	0	1	2
OG0008459	0	1	0	1	2
OG0008460	0	1	1	0	2
OG0008461	0	1	0	1	2
OG0008462	0	1	1	0	2
OG0008463	0	1	1	0	2
OG0008464	0	1	0	1	2
OG0008465	0	2	0	0	2
OG0008466	0	1	1	0	2
OG0008467	0	1	1	0	2
OG0008468	0	1	0	1	2
OG0008469	0	1	0	1	2
OG0008470	0	1	1	0	2
OG0008471	0	1	0	1	2
OG0008472	0	1	1	0	2
OG0008473	0	1	0	1	2
OG0008474	0	1	1	0	2
OG0008475	0	1	0	1	2
OG0008476	0	1	0	1	2
OG0008477	0	1	0	1	2
OG0008478	0	1	1	0	2
OG0008479	0	1	1	0	2
OG0008480	0	1	1	0	2
OG0008481	0	1	1	0	2
OG0008482	0	1	1	0	2
OG0008483	0	1	0	1	2
OG0008484	0	1	1	0	2
OG0008485	0	1	1	0	2
OG0008486	0	1	1	0	2
OG0008487	0	1	0	1	2
OG0008488	0	1	1	0	2
OG0008489	0	1	1	0	2
OG0008490	0	1	1	0	2
OG0008491	0	1	0	1	2
OG0008492	0	1	1	0	2
OG0008493	0	1	0	1	2
OG0008494	0	1	1	0	2
OG0008495	0	1	1	0	2
OG0008496	0	1	1	0	2
OG0008497	0	1	0	1	2
OG0008498	0	1	0	1	2
OG0008499	0	1	1	0	2
OG0008500	0	1	1	0	2
OG0008501	0	1	1	0	2
OG0008502	0	1	0	1	2
OG0008503	0	1	0	1	2
OG0008504	0	1	1	0	2
OG0008505	0	1	1	0	2
OG0008506	0	1	0	1	2
OG0008507	0	1	1	0	2
OG0008508	0	1	0	1	2
OG0008509	0	1	1	0	2
OG0008510	0	1	1	0	2
OG0008511	0	1	0	1	2
OG0008512	0	1	0	1	2
OG0008513	0	1	0	1	2
OG0008514	0	1	0	1	2
OG0008515	0	1	0	1	2
OG0008516	0	1	1	0	2
OG0008517	0	1	0	1	2
OG0008518	0	1	1	0	2
OG0008519	0	1	0	1	2
OG0008520	0	1	0	1	2
OG0008521	0	1	1	0	2
OG0008522	0	1	0	1	2
OG0008523	0	1	0	1	2
OG0008524	0	1	1	0	2
OG0008525	0	1	1	0	2
OG0008526	0	1	1	0	2
OG0008527	0	1	1	0	2
OG0008528	0	1	0	1	2
OG0008529	0	1	1	0	2
OG0008530	0	1	1	0	2
OG0008531	0	1	1	0	2
OG0008532	0	1	1	0	2
OG0008533	0	1	1	0	2
OG0008534	0	1	1	0	2
OG0008535	0	1	0	1	2
OG0008536	0	1	0	1	2
OG0008537	0	1	1	0	2
OG0008538	0	1	0	1	2
OG0008539	0	1	0	1	2
OG0008540	0	1	1	0	2
OG0008541	0	1	1	0	2
OG0008542	0	1	0	1	2
OG0008543	0	1	1	0	2
OG0008544	0	1	1	0	2
OG0008545	0	1	0	1	2
OG0008546	0	1	0	1	2
OG0008547	0	1	0	1	2
OG0008548	0	1	0	1	2
OG0008549	0	1	0	1	2
OG0008550	0	1	1	0	2
OG0008551	0	1	0	1	2
OG0008552	0	1	0	1	2
OG0008553	0	1	1	0	2
OG0008554	0	1	0	1	2
OG0008555	0	1	1	0	2
OG0008556	0	1	0	1	2
OG0008557	0	1	0	1	2
OG0008558	0	1	1	0	2
OG0008559	0	1	1	0	2
OG0008560	0	1	1	0	2
OG0008561	0	1	1	0	2
OG0008562	0	1	0	1	2
OG0008563	0	1	1	0	2
OG0008564	0	1	1	0	2
OG0008565	0	1	1	0	2
OG0008566	0	1	0	1	2
OG0008567	0	1	1	0	2
OG0008568	0	1	1	0	2
OG0008569	0	0	2	0	2
OG0008570	0	0	1	1	2
OG0008571	0	0	1	1	2
OG0008572	0	0	1	1	2
OG0008573	0	0	2	0	2
OG0008574	0	0	1	1	2
OG0008575	0	0	1	1	2
OG0008576	0	0	1	1	2
OG0008577	0	0	1	1	2
OG0008578	0	0	1	1	2
OG0008579	0	0	1	1	2
OG0008580	0	0	1	1	2
OG0008581	0	0	1	1	2
OG0008582	0	0	1	1	2
OG0008583	0	0	1	1	2
OG0008584	0	0	1	1	2
OG0008585	0	0	1	1	2
OG0008586	0	0	1	1	2
OG0008587	0	0	1	1	2
OG0008588	0	0	1	1	2
OG0008589	0	0	2	0	2
OG0008590	0	0	1	1	2
OG0008591	0	0	1	1	2
OG0008592	0	0	1	1	2
OG0008593	0	0	1	1	2
OG0008594	0	0	1	1	2
OG0008595	0	0	1	1	2
OG0008596	0	0	1	1	2
OG0008597	0	0	1	1	2
OG0008598	0	0	1	1	2
OG0008599	0	0	1	1	2
OG0008600	0	0	1	1	2
OG0008601	0	0	1	1	2
OG0008602	0	0	1	1	2
OG0008603	0	0	1	1	2
OG0008604	0	0	1	1	2
OG0008605	0	0	1	1	2
OG0008606	0	0	1	1	2
OG0008607	0	0	1	1	2
OG0008608	0	0	1	1	2
OG0008609	0	0	1	1	2
OG0008610	0	0	1	1	2
OG0008611	0	0	1	1	2
OG0008612	0	0	1	1	2
OG0008613	0	0	1	1	2
OG0008614	0	0	1	1	2
OG0008615	0	0	1	1	2
OG0008616	0	0	1	1	2
OG0008617	0	0	1	1	2
OG0008618	0	0	2	0	2
OG0008619	0	0	1	1	2
OG0008620	0	0	1	1	2
OG0008621	0	0	1	1	2
OG0008622	0	0	2	0	2
OG0008623	0	0	1	1	2
OG0008624	0	0	1	1	2
OG0008625	0	0	1	1	2
OG0008626	0	0	1	1	2
OG0008627	0	0	2	0	2
OG0008628	0	0	1	1	2
OG0008629	0	0	1	1	2
OG0008630	0	0	1	1	2
OG0008631	0	0	1	1	2
OG0008632	0	0	1	1	2
OG0008633	0	0	1	1	2
OG0008634	0	0	1	1	2
OG0008635	0	0	2	0	2
OG0008636	0	0	1	1	2
OG0008637	0	0	1	1	2
OG0008638	0	0	1	1	2
OG0008639	0	0	1	1	2
OG0008640	0	0	1	1	2
OG0008641	0	0	1	1	2
OG0008642	0	0	1	1	2
OG0008643	0	0	1	1	2
OG0008644	0	0	1	1	2
OG0008645	0	0	1	1	2
OG0008646	0	0	1	1	2
OG0008647	0	0	1	1	2
OG0008648	0	0	1	1	2
OG0008649	0	0	1	1	2
OG0008650	0	0	1	1	2
OG0008651	0	0	1	1	2
OG0008652	0	0	1	1	2
OG0008653	0	0	1	1	2
OG0008654	0	0	1	1	2
OG0008655	0	0	1	1	2
OG0008656	0	0	1	1	2
OG0008657	0	0	2	0	2
OG0008658	0	0	1	1	2
OG0008659	0	0	2	0	2
OG0008660	0	0	1	1	2
OG0008661	0	0	1	1	2
OG0008662	0	0	2	0	2
OG0008663	0	0	1	1	2
OG0008664	0	0	1	1	2
OG0008665	0	0	1	1	2
OG0008666	0	0	1	1	2
OG0008667	0	0	1	1	2
OG0008668	0	0	1	1	2
OG0008669	0	0	1	1	2
OG0008670	0	0	1	1	2
OG0008671	0	0	1	1	2
OG0008672	0	0	1	1	2
OG0008673	0	0	1	1	2
OG0008674	0	0	1	1	2
OG0008675	0	0	1	1	2
OG0008676	0	0	2	0	2
OG0008677	0	0	1	1	2
OG0008678	0	0	1	1	2
OG0008679	0	0	1	1	2
OG0008680	0	0	1	1	2
OG0008681	0	0	1	1	2
OG0008682	0	0	2	0	2
OG0008683	0	0	1	1	2
OG0008684	0	0	1	1	2
OG0008685	0	0	1	1	2
OG0008686	0	0	1	1	2
OG0008687	0	0	1	1	2
OG0008688	0	0	1	1	2
OG0008689	0	0	1	1	2
OG0008690	0	0	1	1	2
OG0008691	0	0	1	1	2
OG0008692	0	0	1	1	2
OG0008693	0	0	1	1	2
OG0008694	0	0	1	1	2
OG0008695	0	0	1	1	2
OG0008696	0	0	1	1	2
OG0008697	0	0	1	1	2
OG0008698	0	0	1	1	2
OG0008699	0	0	1	1	2
OG0008700	0	0	1	1	2
OG0008701	0	0	1	1	2
OG0008702	0	0	1	1	2
OG0008703	0	0	1	1	2
OG0008704	0	0	1	1	2
OG0008705	0	0	1	1	2
OG0008706	0	0	1	1	2
OG0008707	0	0	1	1	2
OG0008708	0	0	1	1	2
OG0008709	0	0	1	1	2
OG0008710	0	0	1	1	2
OG0008711	0	0	1	1	2
OG0008712	0	0	1	1	2
OG0008713	0	0	1	1	2
OG0008714	0	0	2	0	2
OG0008715	0	0	1	1	2
OG0008716	0	0	1	1	2
OG0008717	0	0	1	1	2
OG0008718	0	0	1	1	2
OG0008719	0	0	1	1	2
OG0008720	0	0	1	1	2
OG0008721	0	0	1	1	2
OG0008722	0	0	2	0	2
OG0008723	0	0	1	1	2
OG0008724	0	0	2	0	2
OG0008725	0	0	1	1	2
OG0008726	0	0	1	1	2
OG0008727	0	0	1	1	2
OG0008728	0	0	1	1	2
OG0008729	0	0	1	1	2
OG0008730	0	0	1	1	2
OG0008731	0	0	1	1	2
OG0008732	0	0	1	1	2
OG0008733	0	0	1	1	2
OG0008734	0	0	1	1	2
OG0008735	0	0	1	1	2
OG0008736	0	0	1	1	2
OG0008737	0	0	1	1	2
OG0008738	0	0	1	1	2
OG0008739	0	0	1	1	2
OG0008740	0	0	2	0	2
OG0008741	0	0	1	1	2
OG0008742	0	0	1	1	2
OG0008743	0	0	2	0	2
OG0008744	0	0	1	1	2
OG0008745	0	0	1	1	2
OG0008746	0	0	1	1	2
OG0008747	0	0	1	1	2
OG0008748	0	0	2	0	2
OG0008749	0	0	2	0	2
OG0008750	0	0	2	0	2
OG0008751	0	0	1	1	2
OG0008752	0	0	2	0	2
OG0008753	0	0	1	1	2
OG0008754	0	0	2	0	2
OG0008755	0	0	2	0	2
OG0008756	0	0	1	1	2
OG0008757	0	0	2	0	2
OG0008758	0	0	1	1	2
OG0008759	0	0	2	0	2
OG0008760	0	0	1	1	2
OG0008761	0	0	1	1	2
OG0008762	0	0	1	1	2
OG0008763	0	0	1	1	2
OG0008764	0	0	1	1	2
OG0008765	0	0	1	1	2
OG0008766	0	0	1	1	2
OG0008767	0	0	1	1	2
OG0008768	0	0	1	1	2
OG0008769	0	0	1	1	2
OG0008770	0	0	1	1	2
OG0008771	0	0	1	1	2
OG0008772	0	0	1	1	2
OG0008773	0	0	1	1	2
OG0008774	0	0	0	2	2
OG0008775	0	0	0	2	2
OG0008776	0	0	0	2	2
OG0008777	0	0	0	2	2
OG0008778	0	0	0	2	2
OG0008779	0	0	0	2	2
OG0008780	0	0	0	2	2
OG0008781	0	0	0	2	2
OG0008782	0	0	0	2	2
OG0008783	0	0	0	2	2
OG0008784	0	0	0	2	2
OG0008785	0	0	0	2	2
OG0008786	0	0	0	2	2
OG0008787	0	0	0	2	2
OG0008788	0	0	0	2	2
OG0008789	0	0	0	2	2
OG0008790	0	0	0	2	2
OG0008791	0	0	0	2	2
OG0008792	0	0	0	2	2
OG0008793	0	0	0	2	2
OG0008794	0	0	0	2	2
OG0008795	0	0	0	2	2
OG0008796	0	0	0	2	2
